Dd, Dd, Dd, Dd, Dd, Dd, Dd, Dd, Dd, Dd, Dd, Dd, Dd, Dd, Dd, Dd, Dd, Dd, Dd, Dd, Dd, Dd, Dd, Dd, Dd, Dd, Dd, Dd, Dd, Dd, Dd, Dd, Dd, Dd, Dd, Dd, Dd, Dd, Dd, Dd, Dd, Dd, Dd, Dd, Dd, Dd, Dd, Dd, Dd, Dd, Dd, Dd, Dd, Dd, Dd, Dd, Dd, Dd, Dd, Dd, Dd, Dd, Dd, Dd, Dd, Dd, Dd, Dd, Dd, Dd, Dd, Dd, Dd, Dd, Dd, Dd, Dd, Dd, Dd, Dd, Dd, Dd
Dd, Dd, Dd, Dd, Dd, Dd, Dd, Dd, Dd, Dd, Dd, Dd, Dd, Dd, Dd, Dd, Dd, Dd, Dd, Dd, Dd, Dd, Dd, Dd, Dd, Dd, Dd, Dd, Dd, Dd, Dd, Dd, Dd, Dd, Dd, Dd, Dd, Dd, Dd, Dd, Dd, Dd, Dd, Dd, Dd, Dd, Dd, Dd, Dd, Dd, Dd, Dd, Dd, Dd, Dd, Dd, Dd, Dd, Dd, Dd, Dd, Dd, Dd, Dd, Dd, Dd, Dd, Dd, Dd, Dd, Dd, Dd, Dd, Dd, Dd, Dd, Dd, Dd, Dd, Dd, Dd, Dd
Dd, Dd, Dd, Dd, Dd, Dd, Dd, Dd, Dd, Dd, Dd, Dd, Dd, Dd, Dd, Dd, Dd, Dd, Dd, Dd, Dd, Dd, Dd, Dd, Dd, Dd, Dd, Dd, Dd, Dd, Dd, Dd, Dd, Dd, Dd, Dd, Dd, Dd, Dd, Dd, Dd, Dd, Dd, Dd, Dd, Dd, Dd, Dd, Dd, Dd, Dd, Dd, Dd, Dd, Dd, Dd, Dd, Dd, Dd, Dd, Dd, Dd, Dd, Dd, Dd, Dd, Dd, Dd, Dd, Dd, Dd, Dd, Dd, Dd, Dd, Dd, Dd, Dd, Dd, Dd, Dd, Dd
Dd, Dd, Dd, Dd, Dd, Dd, Dd, Dd, Dd, Dd, Dd, Dd, Dd, Dd, Dd, Dd, Dd, Dd, Dd, Dd, Dd, Dd, Dd, Dd, Dd, Dd, Dd, Dd, Dd, Dd, Dd, Dd, Dd, Dd, Dd, Dd, Dd, Dd, Dd, Dd, Dd, Dd, Dd, Dd, Dd, Dd, Dd, Dd, Dd, Dd, Dd, Dd, Dd, Dd, Dd, Dd, Dd, Dd, Dd, Dd, Dd, Dd, Dd, Dd, Dd, Dd, Dd, Dd, Dd, Dd, Dd, Dd, Dd, Dd, Dd, Dd, Dd, Dd, Dd, Dd, Dd, Dd
Dd, Dd, Dd, Dd, Dd, Dd, Dd, Dd, Dd, Dd, Dd, Dd, Dd, Dd, Dd, Dd, Dd, Dd, Dd, Dd, Dd, Dd, Dd, Dd, Dd, Dd, Dd, Dd, Dd, Dd, Dd, Dd, Dd, Dd, Dd, Dd, Dd, Dd, Dd, Dd, Dd, Dd, Dd, Dd, Dd, Dd, Dd, Dd, Dd, Dd, Dd, Dd, Dd, Dd, Dd, Dd, Dd, Dd, Dd, Dd, Dd, Dd, Dd, Dd, Dd, Dd, Dd, Dd, Dd, Dd, Dd, Dd, Dd, Dd, Dd, Dd, Dd, Dd, Dd, Dd, Dd, Dd
Dd, Dd, Dd, Dd, Dd, Dd, Dd, Dd, Dd, Dd, Dd, Dd, Dd, Dd, Dd, Dd, Dd, Dd, Dd, Dd, Dd, Dd, Dd, Dd, Dd, Dd, Dd, Dd, Dd, Dd, Dd, Dd, Dd, Dd, Dd, Dd, Dd, Dd, Dd, Dd, Dd, Dd, Dd, Dd, Dd, Dd, Dd, Dd, Dd, Dd, Dd, Dd, Dd, Dd, Dd, Dd, Dd, Dd, Dd, Dd, Dd, Dd, Dd, Dd, Dd, Dd, Dd, Dd, Dd, Dd, Dd, Dd, Dd, Dd, Dd, Dd, Dd, Dd, Dd, Dd, Dd, Dd
Dd, Dd, Dd, Dd, Dd, Dd, Dd, Dd, Dd, Dd, Dd, Dd, Dd, Dd, Dd, Dd, Dd, Dd, Dd, Dd, Dd, Dd, Dd, Dd, Dd, Dd, Dd, Dd, Dd, Dd, Dd, Dd, Dd, Dd, Dd, Dd, Dd, Dd, Dd, Dd, Dd, Dd, Dd, Dd, Dd, Dd, Dd, Dd, Dd, Dd, Dd, Dd, Dd, Dd, Dd, Dd, Dd, Dd, Dd, Dd, Dd, Dd, Dd, Dd, Dd, Dd, Dd, Dd, Dd, Dd, Dd, Dd, Dd, Dd, Dd, Dd, Dd, Dd, Dd, Dd, Dd, Dd
Dd, Dd, Dd, Dd, Dd, Dd, Dd, Dd, Dd, Dd, Dd, Dd, Dd, Dd, Dd, Dd, Dd, Dd, Dd, Dd, Dd, Dd, Dd, Dd, Dd, Dd, Dd, Dd, Dd, Dd, Dd, Dd, Dd, Dd, Dd, Dd, Dd, Dd, Dd, Dd, Dd, Dd, Dd, Dd, Dd, Dd, Dd, Dd, Dd, Dd, Dd, Dd, Dd, Dd, Dd, Dd, Dd, Dd, Dd, Dd, Dd, Dd, Dd, Dd, Dd, Dd, Dd, Dd, Dd, Dd, Dd, Dd, Dd, Dd, Dd, Dd, Dd, Dd, Dd, Dd, Dd, Dd
Dd, Dd, Dd, Dd, Dd, Dd, Dd, Dd, Dd, Dd, Dd, Dd, Dd, Dd, Dd, Dd, Dd, Dd, Dd, Dd, Dd, Dd, Dd, Dd, Dd, Dd, Dd, Dd, Dd, Dd, Dd, Dd, Dd, Dd, Dd, Dd, Dd, Dd, Dd, Dd, Dd, Dd, Dd, Dd, Dd, Dd, Dd, Dd, Dd, Dd, Dd, Dd, Dd, Dd, Dd, Dd, Dd, Dd, Dd, Dd, Dd, Dd, Dd, Dd, Dd, Dd, Dd, Dd, Dd, Dd, Dd, Dd, Dd, Dd, Dd, Dd, Dd, Dd, Dd, Dd, Dd, Dd
Dd, Dd, Dd, Dd, Dd, Dd, Dd, Dd, Dd, Dd, Dd, Dd, Dd, Dd, Dd, Dd, Dd, Dd, Dd, Dd, Dd, Dd, Dd, Dd, Dd, Dd, Dd, Dd, Dd, Dd, Dd, Dd, Dd, Dd, Dd, Dd, Dd, Dd, Dd, Dd, Dd, Dd, Dd, Dd, Dd, Dd, Dd, Dd, Dd, Dd, Dd, Dd, Dd, Dd, Dd, Dd, Dd, Dd, Dd, Dd, Dd, Dd, Dd, Dd, Dd, Dd, Dd, Dd, Dd, Dd, Dd, Dd, Dd, Dd, Dd, Dd, Dd, Dd, Dd, Dd, Dd, Dd
Dd, Dd, Dd, Dd, Dd, Dd, Dd, Dd, Dd, Dd, Dd, Dd, Dd, Dd, Dd, Dd, Dd, Dd, Dd, Dd, Dd, Dd, Dd, Dd, Dd, Dd, Dd, Dd, Dd, Dd, Dd, Dd, Dd, Dd, Dd, Dd, Dd, Dd, Dd, Dd, Dd, Dd, Dd, Dd, Dd, Dd, Dd, Dd, Dd, Dd, Dd, Dd, Dd, Dd, Dd, Dd, Dd, Dd, Dd, Dd, Dd, Dd, Dd, Dd, Dd, Dd, Dd, Dd, Dd, Dd, Dd, Dd, Dd, Dd, Dd, Dd, Dd, Dd, Dd, Dd, Dd, Dd
Dd, Dd, Dd, Dd, Dd, Dd, Dd, Dd, Dd, Dd, Dd, Dd, Dd, Dd, Dd, Dd, Dd, Dd, Dd, Dd, Dd, Dd, Dd, Dd, Dd, Dd, Dd, Dd, Dd, Dd, Dd, Dd, Dd, Dd, Dd, Dd, Dd, Dd, Dd, Dd, Dd, Dd, Dd, Dd, Dd, Dd, Dd, Dd, Dd, Dd, Dd, Dd, Dd, Dd, Dd, Dd, Dd, Dd, Dd, Dd, Dd, Dd, Dd, Dd, Dd, Dd, Dd, Dd, Dd, Dd, Dd, Dd, Dd, Dd, Dd, Dd, Dd, Dd, Dd, Dd, Dd, Dd
Dd, Dd, Dd, Dd, Dd, Dd, Dd, Dd, Dd, Dd, Dd, Dd, Dd, Dd, Dd, Dd, Dd, Dd, Dd, Dd, Dd, Dd, Dd, Dd, Dd, Dd, Dd, Dd, Dd, Dd, Dd, Dd, Dd, Dd, Dd, Dd, Dd, Dd, Dd, Dd, Dd, Dd, Dd, Dd, Dd, Dd, Dd, Dd, Dd, Dd, Dd, Dd, Dd, Dd, Dd, Dd, Dd, Dd, Dd, Dd, Dd, Dd, Dd, Dd, Dd, Dd, Dd, Dd, Dd, Dd, Dd, Dd, Dd, Dd, Dd, Dd, Dd, Dd, Dd, Dd, Dd, Dd
Dd, Dd, Dd, Dd, Dd, Dd, Dd, Dd, Dd, Dd, Dd, Dd, Dd, Dd, Dd, Dd, Dd, Dd, Dd, Dd, Dd, Dd, Dd, Dd, Dd, Dd, Dd, Dd, Dd, Dd, Dd, Dd, Dd, Dd, Dd, Dd, Dd, Dd, Dd, Dd, Dd, Dd, Dd, Dd, Dd, Dd, Dd, Dd, Dd, Dd, Dd, Dd, Dd, Dd, Dd, Dd, Dd, Dd, Dd, Dd, Dd, Dd, Dd, Dd, Dd, Dd, Dd, Dd, Dd, Dd, Dd, Dd, Dd, Dd, Dd, Dd, Dd, Dd, Dd, Dd, Dd, Dd
Dd, Dd, Dd, Dd, Dd, Dd, Dd, Dd, Dd, Dd, Dd, Dd, Dd, Dd, Dd, Dd, Dd, Dd, Dd, Dd, Dd, Dd, Dd, Dd, Dd, Dd, Dd, Dd, Dd, Dd, Dd, Dd, Dd, Dd, Dd, Dd, Dd, Dd, Dd, Dd, Dd, Dd, Dd, Dd, Dd, Dd, Dd, Dd, Dd, Dd, Dd, Dd, Dd, Dd, Dd, Dd, Dd, Dd, Dd, Dd, Dd, Dd, Dd, Dd, Dd, Dd, Dd, Dd, Dd, Dd, Dd, Dd, Dd, Dd, Dd, Dd, Dd, Dd, Dd, Dd, Dd, Dd
Dd, Dd, Dd, Dd, Dd, Dd, Dd, Dd, Dd, Dd, Dd, Dd, Dd, Dd, Dd, Dd, Dd, Dd, Dd, Dd, Dd, Dd, Dd, Dd, Dd, Dd, Dd, Dd, Dd, Dd, Dd, Dd, Dd, Dd, Dd, Dd, Dd, Dd, Dd, Dd, Dd, Dd, Dd, Dd, Dd, Dd, Dd, Dd, Dd, Dd, Dd, Dd, Dd, Dd, Dd, Dd, Dd, Dd, Dd, Dd, Dd, Dd, Dd, Dd, Dd, Dd, Dd, Dd, Dd, Dd, Dd, Dd, Dd, Dd, Dd, Dd, Dd, Dd, Dd, Dd, Dd, Dd
Dd, Dd, Dd, Dd, Dd, Dd, Dd, Dd, Dd, Dd, Dd, Dd, Dd, Dd, Dd, Dd, Dd, Dd, Dd, Dd, Dd, Dd, Dd, Dd, Dd, Dd, Dd, Dd, Dd, Dd, Dd, Dd, Dd, Dd, Dd, Dd, Dd, Dd, Dd, Dd, Dd, Dd, Dd, Dd, Dd, Dd, Dd, Dd, Dd, Dd, Dd, Dd, Dd, Dd, Dd, Dd, Dd, Dd, Dd, Dd, Dd, Dd, Dd, Dd, Dd, Dd, Dd, Dd, Dd, Dd, Dd, Dd, Dd, Dd, Dd, Dd, Dd, Dd, Dd, Dd, Dd, Dd
Dd, Dd, Dd, Dd, Dd, Dd, Dd, Dd, Dd, Dd, Dd, Dd, Dd, Dd, Dd, Dd, Dd, Dd, Dd, Dd, Dd, Dd, Dd, Dd, Dd, Dd, Dd, Dd, Dd, Dd, Dd, Dd, Dd, Dd, Dd, Dd, Dd, Dd, Dd, Dd, Dd, Dd, Mdd, Dd, Dd, Dd, Dd, Dd, Dd, Dd, Dd, Dd, Dd, Dd, Dd, Dd, Dd, Dd, Dd, Dd, Dd, Dd, Dd, Dd, Dd, Dd, Dd, Dd, Dd, Dd, Dd, Dd, Dd, Dd, Dd, Dd, Dd, Dd, Dd, Dd, Dd, Dd
Dd, Dd, Dd, Dd, Dd, Dd, Dd, Dd, Dd, Dd, Dd, Dd, Dd, Dd, Dd, Dd, Dd, Dd, Dd, Dd, Dd, Dd, Dd, Dd, Dd, Dd, Dd, Dd, Dd, Dd, Dd, Dd, Xoa, Xoa, Xoa, Mdd, Mdd, Dd, Mdd, Mdd, Mdd, Mdd, Mdd, Mdd, Mdd, Dd, Dd, Dd, Dd, Dd, Dd, Dd, Dd, Dd, Dd, Dd, Dd, Dd, Dd, Dd, Dd, Dd, Dd, Dd, Dd, Dd, Dd, Dd, Dd, Dd, Dd, Dd, Dd, Dd, Dd, Dd, Dd, Dd, Dd, Dd, Dd, Dd
Dd, Dd, Dd, Dd, Dd, Dd, Dd, Dd, Dd, Dd, Dd, Dd, Dd, Dd, Dd, Dd, Dd, Dd, Dd, Dd, Dd, Dd, Dd, Dd, Dd, Dd, Dd, Dd, Mdd, Mdd, Mdd, Xoa, Uu, Uu, Uu, Xoa, Mdd, Mdd, Mdd, Mdd, Mdd, Mdd, Mdd, Mdd, Mdd, Mdd, Mdd, Mdd, Mdd, Dd, Mdd, Dd, Mdd, Dd, Dd, Dd, Dd, Dd, Dd, Dd, Dd, Dd, Dd, Dd, Dd, Dd, Dd, Dd, Dd, Dd, Dd, Dd, Dd, Dd, Dd, Dd, Dd, Dd, Dd, Dd, Dd, Dd
Dd, Dd, Dd, Dd, Dd, Dd, Dd, Dd, Dd, Dd, Dd, Dd, Dd, Dd, Dd, Dd, Dd, Dd, Dd, Dd, Dd, Dd, Dd, Dd, Dd, Dd, Mdd, Mdd, Mdd, Mdd, Mdd, Xoa, Uu, Uu, Uu, Xoa, Mdd, Mdd, Mdd, Mdd, Mdd, Mdd, Mdd, Mdd, Mdd, Mdd, Mdd, Mdd, Mdd, Mdd, Mdd, Mdd, Mdd, Mdd, Mdd, Dd, Dd, Dd, Dd, Dd, Dd, Dd, Dd, Dd, Dd, Dd, Dd, Dd, Dd, Dd, Dd, Dd, Dd, Dd, Dd, Dd, Dd, Dd, Dd, Dd, Dd, Dd
Dd, Dd, Dd, Dd, Dd, Dd, Dd, Dd, Dd, Dd, Dd, Dd, Dd, Dd, Dd, Dd, Dd, Dd, Dd, Dd, Dd, Dd, Dd, Dd, Mdd, Mdd, Mdd, Mdd, Mdd, Mdd, Mdd, Xoa, Xoa, Uu, Xoa, Xoa, Mdd^Xm, Mdd^Xm, Mdd^Xm, Mdd^Xm, Mdd^Xm, Mdd^Xm, Mdd^Xm, Mdd, Mdd^Xm, Mdd^Xm, Mdd^Xm, Mdd, Mdd, Mdd, Xoa, Xoa, Xoa, Mdd, Mdd, Mdd, Mdd, Dd, Dd, Dd, Dd, Dd, Dd, Dd, Dd, Dd, Dd, Dd, Dd, Dd, Dd, Dd, Dd, Dd, Dd, Dd, Dd, Dd, Dd, Dd, Dd, Dd
Dd, Dd, Dd, Dd, Dd, Dd, Dd, Dd, Dd, Dd, Dd, Dd, Dd, Dd, Dd, Dd, Dd, Dd, Dd, Dd, Dd, Dd, Dd, Mdd, Mdd, Mdd, Mdd, Mdd, Mdd, Mdd, Mdd, Mdd, Mdd, Xoa, Mdd^Xm, Mdd^Xm, Mdd^Xm, Mdd^Xm, Xu, Xu, Xu, Mdd^Xm, Xu, Mdd^Xm, Xu, Mdd^Xm, Mdd^Xm, Mdd^Xm, Mdd, Xoa, Uu, Uu, Uu, Xoa, Mdd, Mdd, Mdd, Mdd, Dd, Dd, Dd, Dd, Dd, Dd, Dd, Dd, Dd, Dd, Dd, Dd, Dd, Dd, Dd, Dd, Dd, Dd, Dd, Dd, Dd, Dd, Dd, Dd
Dd, Dd, Dd, Dd, Dd, Dd, Dd, Dd, Dd, Dd, Dd, Dd, Dd, Dd, Dd, Dd, Dd, Dd, Dd, Dd, Dd, Dd, Dd, Mdd, Mdd, Mdd, Mdd, Mdd, Mdd, Mdd, Mdd, Mdd, Mdd^Xm, Mdd^Xm, Xu, Xu, Xu, Xu, Qxua, Qxua, Qxua, Xu, Qxua, Xu, Qxua, Xu, Xu, Mdd^Xm, Mdd^Xm, Xoa, Uu, Uu, Uu, Xoa, Mdd, Mdd, Mdd, Mdd, Mdd, Dd, Dd, Dd, Dd, Dd, Dd, Dd, Dd, Dd, Dd, Dd, Dd, Dd, Dd, Dd, Dd, Dd, Dd, Dd, Dd, Dd, Dd, Dd
Dd, Dd, Dd, Dd, Dd, Dd, Dd, Dd, Dd, Dd, Dd, Dd, Dd, Dd, Dd, Dd, Dd, Dd, Dd, Dd, Dd, Dd, Mdd, Mdd, Mdd, Mdd, Mdd, Mdd, Xoa, Mdd, Mdd, Mdd^Xm, Xu, Xu, Qxua, Qxua, Qxua, Qxua, Qxua, Qxua, Qxua, Qxua, Qxua, Qxua, Qxua, Qxua, Qxua, Xu, Mdd^Xm, Xoa, Xoa, Uu, Xoa, Xoa, Mdd, Mdd, Mdd, Mdd, Mdd, Mdd, Dd, Dd, Dd, Dd, Dd, Dd, Dd, Dd, Dd, Dd, Dd, Dd, Dd, Dd, Dd, Dd, Dd, Dd, Dd, Dd, Dd, Dd
Dd, Dd, Dd, Dd, Dd, Dd, Dd, Dd, Dd, Dd, Dd, Dd, Dd, Dd, Dd, Dd, Dd, Dd, Dd, Dd, Dd, Dd, Mdd, Mdd, Mdd, Mdd, Xoa, Xoa, Uu, Xoa, Xoa, Mdd^Xm, Xu, Qxua, Qxua, Qxua, Qxua, Qxua, Qxua, Qxua, Tb^Tf, Qxua, Uu, Qxua, Qxua, Qxua, Qxua, Xu, Xu, Mdd^Xm, Mdd, Xoa, Mdd, Mdd, Mdd, Mdd, Mdd, Mdd, Mdd, Mdd, Dd, Dd, Dd, Dd, Dd, Dd, Dd, Dd, Dd, Dd, Dd, Dd, Dd, Dd, Dd, Dd, Dd, Dd, Dd, Dd, Dd, Dd
Dd, Dd, Dd, Dd, Dd, Dd, Dd, Dd, Dd, Dd, Dd, Dd, Dd, Dd, Dd, Dd, Dd, Dd, Dd, Dd, Dd, Dd, Mdd, Mdd, Mdd, Mdd, Xoa, Uu, Uu, Uu, Xoa, Mdd^Xm, Xu, Qxua, Qxua, Qxua, Uh, Uh, Urb, Ur, Rd^Sr, Tb^Tf, Uu, Uh, Uh, Qxua, Qxua, Qxua, Xu, Mdd^Xm, Mdd, Mdd, Mdd, Mdd, Xoa, Xoa, Xoa, Mdd, Mdd, Mdd, Dd, Dd, Dd, Dd, Dd, Dd, Dd, Dd, Dd, Dd, Dd, Dd, Dd, Dd, Dd, Dd, Dd, Dd, Dd, Dd, Dd, Dd
Dd, Dd, Dd, Dd, Dd, Dd, Dd, Dd, Dd, Dd, Dd, Dd, Dd, Dd, Dd, Dd, Dd, Dd, Dd, Dd, Dd, Dd, Mdd, Mdd, Mdd, Mdd, Xoa, Uu, Uu, Uu, Xoa, Mdd^Xm, Xu, Qxua, Qxua, Qxua, Tb^Tf, Uh, Urb, Rd^Sr, Rd^Sc, Rd^Sr, Ur, Uh, Qxua, Qxua, Qxua, Qxua, Xu, Mdd^Xm, Mdd, Mdd, Mdd, Xoa, Uu, Uu, Uu, Xoa, Mdd, Dd, Dd, Dd, Dd, Dd, Dd, Dd, Dd, Dd, Dd, Dd, Dd, Dd, Dd, Dd, Dd, Dd, Dd, Dd, Dd, Dd, Dd, Dd
Dd, Dd, Dd, Dd, Dd, Dd, Dd, Dd, Dd, Dd, Dd, Dd, Dd, Dd, Dd, Dd, Dd, Dd, Dd, Dd, Dd, Dd, Mdd, Mdd, Mdd, Mdd, Mdd, Xoa, Xoa, Xoa, Mdd^Xm, Mdd^Xm, Xu, Qxua, Qxua, Qxua, Tb^Tf, Urb, Uu, Rd^Sr, Rd^Sr, Rd^Sr, Uu, Ur, Qxua, Qxua, Qxua, Qxua, Xu, Mdd^Xm, Mdd, Mdd, Mdd, Xoa, Uu, Uu, Uu, Xoa, Mdd, Dd, Dd, Dd, Dd, Dd, Dd, Dd, Dd, Dd, Dd, Dd, Dd, Dd, Dd, Dd, Dd, Dd, Dd, Dd, Dd, Dd, Dd, Dd
Dd, Dd, Dd, Dd, Dd, Dd, Dd, Dd, Dd, Dd, Dd, Dd, Dd, Dd, Dd, Dd, Dd, Dd, Dd, Dd, Dd, Dd, Dd, Mdd, Mdd, Mdd, Mdd, Mdd, Mdd, Mdd, Mdd^Xm, Xu, Qxua, Qxua, Qxua, Qxua, Uu, Uh, Uh, Ur, Uh, Uu, Uh, Qxua, Qxua, Qxua, Xu, Xu, Mdd^Xm, Mdd^Xm, Mdd, Mdd, Mdd, Xoa, Xoa, Uu, Xoa, Xoa, Mdd, Dd, Dd, Dd, Dd, Dd, Dd, Dd, Dd, Dd, Dd, Dd, Dd, Dd, Dd, Dd, Dd, Dd, Dd, Dd, Dd, Dd, Dd, Dd
Dd, Dd, Dd, Dd, Dd, Dd, Dd, Dd, Dd, Dd, Dd, Dd, Dd, Dd, Dd, Dd, Dd, Dd, Dd, Dd, Dd, Dd, Dd, Dd, Mdd, Mdd, Mdd, Mdd, Mdd, Mdd, Mdd^Xm, Xu, Xu, Qxua, Qxua, Qxua, Uu, Uh, Urb, Ur, Uh, Uh, Qxua, Qxua, Qxua, Qxua, Xu, Mdd^Xm, Mdd^Xm, Mdd, Xoa, Mdd, Mdd, Mdd, Mdd, Xoa, Mdd, Mdd, Mdd, Dd, Dd, Dd, Dd, Dd, Dd, Dd, Dd, Dd, Dd, Dd, Dd, Dd, Dd, Dd, Dd, Dd, Dd, Dd, Dd, Dd, Dd, Dd
Dd, Dd, Dd, Dd, Dd, Dd, Dd, Dd, Dd, Dd, Dd, Dd, Dd, Dd, Dd, Dd, Dd, Dd, Dd, Dd, Dd, Dd, Dd, Dd, Dd, Mdd, Mdd, Mdd, Mdd, Mdd, Mdd^Xm, Mdd^Xm, Xu, Qxua, Uh, Uh, Tb^Tf, Uu, Urb, Urb, Tb^Tf, Tb^Tf, Xu, Qxua, Xu, Xu, Xu, Mdd^Xm, Xoa, Xoa, Uu, Xoa, Xoa, Mdd, Mdd, Mdd, Mdd, Mdd, Mdd, Mdd, Dd, Dd, Dd, Dd, Dd, Dd, Dd, Dd, Dd, Dd, Dd, Dd, Dd, Dd, Dd, Dd, Dd, Dd, Dd, Dd, Dd, Dd
Dd, Dd, Dd, Dd, Dd, Dd, Dd, Dd, Dd, Dd, Dd, Dd, Dd, Dd, Dd, Dd, Dd, Dd, Dd, Dd, Hd, Hd, Mdd, Mdd, Mdd, Mdd, Mdd, Mdd, Mdd, Mdd, Mdd^Xm, Xu, Uu, Ur, Uu, Uh, Tb^Tf, Tb^Tf, Uu, Uu, Uu, Tb^Tf, Xu, Xu, Mdd^Xm, Xu, Mdd^Xm, Mdd^Xm, Xoa, Uu, Uu, Uu, Xoa, Mdd, Mdd, Mdd, Mdd, Mdd, Mdd, Mdd, Dd, Dd, Dd, Dd, Dd, Dd, Dd, Dd, Dd, Dd, Dd, Dd, Dd, Dd, Dd, Dd, Dd, Dd, Dd, Dd, Dd, Dd
Dd, Dd, Dd, Dd, Dd, Dd, Dd, Dd, Dd, Dd, Dd, Dd, Dd, Dd, Dd, Dd, Dd, Dd, Mdd, Mdd, Mdd, Mdd^Xm, Mdd, Mdd, Mdd, Mdd, Mdd, Mdd, Mdd^Xm, Mdd^Xm, Xu, Xu, Uu, Ur, Uu, Uu, Urb, Urb, Uu, Tb, Xu, Xu, Mdd^Xm, Mdd^Xm, Mdd, Mdd^Xm, Mdd, Mdd, Xoa, Uu, Uu, Uu, Xoa, Mdd, Mdd, Mdd, Mdd, Mdd, Mdd, Mdd, Dd, Dd, Dd, Dd, Dd, Dd, Dd, Dd, Dd, Dd, Dd, Dd, Dd, Dd, Dd, Dd, Dd, Dd, Dd, Dd, Dd, Dd
Dd, Dd, Dd, Dd, Dd, Dd, Dd, Dd, Dd, Dd, Dd, Dd, Dd, Dd, Dd, Dd, Hd, Hd, Mdd, Mdd^Xm, Mdd^Xm, Mdd, Hd, Mdd, Hd, Mdd, Mdd, Mdd, Mdd^Xm, Xu, Tb, Urb, Uh, Urb, Tb, Tb, Urb, Tb, Xu, Tb, Xu, Mdd^Xm, Mdd, Mdd, Mdd, Mdd, Mdd, Mdd, Mdd, Xoa, Xoa, Xoa, Mdd, Mdd, Dd, Dd, Dd, Mdd, Dd, Dd, Dd, Dd, Mdd, Mdd, Mdd, Dd, Mdd, Dd, Dd, Dd, Dd, Dd, Dd, Dd, Dd, Dd, Dd, Dd, Dd, Dd, Dd, Dd
Dd, Dd, Dd, Dd, Dd, Dd, Dd, Dd, Dd, Dd, Dd, Dd, Dd, Dd, Mdd^Xm, Hd, Mdd, Mdd^Xm, Mdd^Xm, Hd, Dd^Ftd, Mdd, Mdd, Hd, Rd, Hd, Dd^Vda, Mdd, Hd, Xu, Tb, Uh, Ur, Ur, Uu, Uu, Uh, Uh, Xu, Xu, Mdd^Xm, Mdd^Xm, Mdd, Mdd, Mdd, Mdd, Mdd, Mdd, Mdd, Mdd, Mdd, Mdd, Mdd, Dd, Dd, Dd, Dd, Dd, Dd, Dd, Dd, Mdd, Mdd, Mdd, Mdd, Mdd, Mdd, Mdd, Dd, Dd, Dd, Dd, Dd, Dd, Dd, Dd, Dd, Dd, Dd, Dd, Dd, Dd
Dd, Dd, Dd, Dd, Dd, Dd, Dd, Dd, Dd, Dd, Dd, Dd, Hd, Mdd, Mdd, Mdd^Xm, Cd, Hd, Dd, Dd^Vda, Dd^Ftd, Dd^Ftd, Rd, Rd, Dd^Ftd, Rd, Cd, Cd, Cd, Hd, Uu, Tb^Tf, Uh, Ur, Uh, Uu, Xu, Xu, Mdd^Xm, Mdd^Xm, Xoa, Xoa, Xoa, Mdd, Mdd, Mdd, Mdd, Mdd, Mdd, Mdd, Mdd, Mdd, Dd, Dd, Dd, Dd, Dd, Dd, Dd, Dd, Dd, Dd, Mdd, Mdd, Mdd, Mdd, Dd, Mdd, Dd, Dd, Dd, Dd, Dd, Dd, Dd, Dd, Dd, Dd, Dd, Dd, Dd, Dd
Dd, Dd, Dd, Dd, Dd, Dd, Dd, Dd, Dd, Dd, Hd, Mdd^Xm, Mdd, Hd, Cd, Cd, Rd, Dd^Vda, Dd^Ftd, Dd, Dd, Rd, Dd^Vda, Dd^Ftd, Dd, Dd^Vda, Cd, Kd, Cd, Hd, Hd, Uu, Uh, Uu, Uh, Xu, Mdd^Xm, Mdd^Xm, Mdd, Xoa, Uu, Uu, Uu, Xoa, Mdd, Mdd, Mdd, Mdd, Mdd, Mdd, Mdd, Mdd, Dd, Dd, Dd, Dd, Dd, Dd, Dd, Dd, Dd, Dd, Dd, Mdd, Dd, Dd, Dd, Dd, Dd, Dd, Dd, Dd, Dd, Dd, Dd, Dd, Dd, Dd, Dd, Dd, Dd, Dd
Dd, Dd, Dd, Dd, Dd, Dd, Dd, Dd, Dd, Hd, Mdd^Xm, Mdd, Hd, Hd, Dd^Vda, Dd, Rd, Dd^Ftd, Dd^Ftd, Dd^Vda, Rd, Rd, Dd^Ftd, Dd^Ftd, Dd, Dd^Ftd, Dd^Ftd, Cd, Rd, Hd, Hd, Uh, Xu, Uu, Xu, Xu, Mdd^Xm, Mdd, Mdd, Xoa, Uu, Uu, Uu, Xoa, Mdd, Mdd, Mdd, Mdd, Mdd, Mdd, Dd, Dd, Dd, Dd, Dd, Dd, Dd, Dd, Dd, Dd, Dd, Dd, Dd, Dd, Dd, Dd, Dd, Dd, Mdd, Dd, Mdd, Dd, Dd, Dd, Dd, Dd, Dd, Dd, Dd, Dd, Dd, Dd
Dd, Dd, Dd, Dd, Dd, Dd, Dd, Dd, Dd, Hd, Mdd, Mdd^Xm, Dd^Ftd, Dd^Ftd, Hd, Dd, Dd^Ftd, Rd, Rd, Rd, Dd^Ftd, Dd^Vda, Dd, Dd, Dd^Vda, Dd^Ftd, Rd, Dd^Vda, Rd, Rd, Rd, Mdd^Xm, Mdd^Xm, Xu, Mdd^Xm, Mdd^Xm, Mdd, Mdd, Mdd, Xoa, Xoa, Uu, Xoa, Xoa, Mdd, Mdd, Mdd, Mdd, Mdd, Mdd, Dd, Dd, Dd, Dd, Dd, Dd, Dd, Dd, Dd, Dd, Dd, Dd, Dd, Dd, Dd, Dd, Dd, Mdd, Mdd, Mdd, Mdd, Dd, Dd, Dd, Dd, Dd, Dd, Dd, Dd, Dd, Dd, Dd
Dd, Dd, Dd, Dd, Dd, Dd, Dd, Dd, Mdd, Mdd^Xm, Mdd, Hd, Dd, Dd^Vda, Dd^Ftd, Hd, Dd^Ftd, Dd^Ftd, Rd, Dd^Ftd, Dd^Ftd, Dd^Ftd, Rd, Rd, Rd, Rd, Wwt, Rd, Dd^Vda, Dd^Ftd, Cd, Cd, Cd, Hd, Mdd, Mdd, Mdd, Mdd, Mdd, Mdd, Mdd, Xoa, Mdd, Mdd, Mdd, Mdd, Mdd, Mdd, Dd, Dd, Dd, Dd, Dd, Dd, Dd, Dd, Dd, Dd, Dd, Dd, Dd, Dd, Dd, Dd, Dd, Dd, Dd, Mdd, Mdd, Mdd, Mdd, Mdd, Dd, Dd, Dd, Dd, Dd, Dd, Dd, Dd, Dd, Dd
Dd, Dd, Dd, Dd, Dd, Dd, Dd, Dd, Hd, Mdd, Hd, Hd, Dd^Ftd, Hd, Dd^Ftd, Dd, Rd, Rd, Cdr, Rd, Rd, Rd, Dd^Ftd, Dd^Ftd, Dd^Ftd, Wwt, Wwt, Dd^Ftd, Dd^Ftd, Dd^Ftd, Cd, Kd, Cd, Hd, Hd, Mdd, Mdd, Mdd, Mdd, Mdd, Mdd, Mdd, Mdd, Mdd, Mdd, Mdd, Mdd, Dd, Dd, Dd, Dd, Dd, Dd, Dd, Dd, Dd, Dd, Dd, Dd, Dd, Dd, Dd, Dd, Dd, Dd, Dd, Dd, Dd, Dd, Mdd, Dd, Dd, Dd, Dd, Dd, Dd, Dd, Dd, Dd, Dd, Dd, Dd
Dd, Dd, Dd, Dd, Dd, Dd, Dd, Dd, Hd, Mdd^Xm, Mdd^Xm, Dd^Ftd, Dd^Ftd, Hd, Dd^Vda, Dd, Rd, Cdr, Kd, Cdr, Rd, Dd^Vda, Wwt, Wwt, Wwt, Wwt, Wwt, Dd^Ftd, Dd^Ftd, Dd, Dd^Vda, Cd, Mdd, Mdd, Hd, Mdd, Mdd, Mdd, Mdd, Mdd, Dd, Dd, Dd, Dd, Dd, Mdd, Dd, Dd, Dd, Dd, Dd, Dd, Dd, Dd, Dd, Dd, Dd, Dd, Dd, Dd, Dd, Dd, Dd, Dd, Dd, Dd, Dd, Dd, Dd, Dd, Dd, Mdd, Hd, Dd, Dd, Dd, Dd, Dd, Dd, Dd, Dd, Dd
Dd, Dd, Dd, Dd, Dd, Dd, Dd, Dd, Dd, Mdd, Cd, Rd, Rd, Dd, Dd^Ftd, Dd^Ftd, Rd, Cdr, Cdr, Cdr, Rd, Dd, Dd^Ftd, Wwt, Dd^Ftd, Wwt, Wwt, Wwt, Wwt, Wwt, Wwt, Hd, Hd, Mdd, Mdd, Mdd, Mdd, Mdd, Mdd, Dd, Dd, Dd, Dd, Dd, Dd, Dd, Dd, Dd, Hd, Dd, Dd, Dd, Dd, Dd, Dd, Dd, Dd, Dd, Dd, Dd, Dd, Dd, Dd, Dd, Dd, Dd, Dd, Dd, Dd, Dd, Hd, Mdd, Mdd, Mdd, Hd, Dd, Dd, Dd, Dd, Dd, Dd, Dd
Dd, Dd, Dd, Dd, Dd, Dd, Dd, Dd, Hd, Hd, Mdd^Xm, Cd, Dd, Rd, Rd, Rd, Dd^Ftd, Rd, Rd, Rd, Rd, Dd^Vda, Dd^Ftd, Dd^Ftd, Wwt, Wwt, Wwt, Wwt, Dd^Ftd, Wwt, Dd, Dd^Ftd, Dd^Ftd, Hd, Mdd, Mdd, Mdd, Mdd, Dd, Dd, Dd, Dd, Dd, Dd, Dd, Dd, Hd, Mdd, Mdd, Hd, Dd, Dd, Dd, Dd, Dd, Dd, Dd, Dd, Dd, Dd, Dd, Dd, Dd, Dd, Dd, Dd, Dd, Dd, Dd, Dd, Mdd, Mdd, Mdd, Mdd, Mdd, Dd, Dd, Dd, Dd, Dd, Dd, Dd
Dd, Dd, Dd, Dd, Dd, Dd, Dd, Dd, Mdd, Mdd^Xm, Mdd, Hd, Dd^Ftd, Dd, Dd, Dd^Ftd, Dd^Vda, Dd^Ftd, Rd, Dd, Dd^Ftd, Rd, Rd, Dd^Ftd, Dd, Wwt, Wwt, Dd^Ftd, Dd^Ftd, Rd, Dd^Vda, Dd^Ftd, Dd^Ftd, Hd, Mdd, Mdd, Mdd^Xm, Mdd^Xm, Dd, Dd, Dd, Dd, Dd, Dd, Dd, Hd, Mdd, Mdd, Mdd, Mdd, Dd, Dd, Dd, Dd, Dd, Dd, Dd, Dd, Dd, Dd, Dd, Dd, Dd, Dd, Dd, Dd, Dd, Dd, Dd, Dd, Dd, Mdd, Hd, Hd, Hd, Dd, Dd, Dd, Dd, Dd, Dd, Dd
Dd, Dd, Dd, Dd, Dd, Dd, Dd, Dd, Hd, Mdd, Mdd^Xm, Hd, Dd^Ftd, Dd^Vda, Dd^Ftd, Hd, Hd, Dd^Ftd, Rd, Dd^Vda, Dd^Ftd, Dd^Ftd, Rd, Dd, Dd^Ftd, Wwt, Dd^Vda, Dd^Ftd, Rd, Rd, Hd, Hd, Hd, Hd, Mdd, Mdd, Mdd^Xm, Mdd, Dd, Dd, Dd, Dd, Dd, Dd, Dd, Dd, Dd, Mdd, Hd, Hd, Dd, Dd, Dd, Dd, Dd, Dd, Dd, Dd, Dd, Dd, Dd, Dd, Dd, Dd, Dd, Dd, Dd, Dd, Dd, Dd, Dd, Dd, Dd, Dd, Dd, Dd, Dd, Dd, Dd, Dd, Dd, Dd
Dd, Dd, Dd, Dd, Dd, Dd, Dd, Dd, Hd, Mdd^Xm, Mdd, Dd^Ftd, Dd, Dd, Dd^Ftd, Dd^Ftd, Rd, Rd, Wwt, Wwt, Wwt, Dd, Dd^Vda, Rd, Dd^Ftd, Dd^Ftd, Rd, Rd, Dd, Dd^Vda, Mdd, Mdd^Xm, Mdd, Mdd^Xm, Mdd^Xm, Mdd^Xm, Mdd, Mdd, Dd, Dd, Dd, Dd, Dd, Dd, Dd, Dd, Dd, Dd, Dd, Dd, Hd, Hd, Mdd, Hd, Mdd, Dd, Dd, Dd, Dd, Dd, Dd, Dd, Dd, Dd, Dd, Dd, Hd, Dd, Dd, Dd, Dd, Dd, Dd, Dd, Dd, Dd, Dd, Dd, Dd, Dd, Dd, Dd
Dd, Dd, Dd, Dd, Dd, Dd, Dd, Hd, Mdd^Xm, Hd, Hd, Dd, Dd^Ftd, Hd, Rd, Rd, Dd^Vda, Dd, Wwt, Wwt, Wwt, Dd^Ftd, Dd^Ftd, Rd, Dd, Dd, Rd, Dd^Ftd, Hd, Mdd, Mdd, Mdd^Xm, Mdd, Mdd, Mdd, Mdd, Mdd, Mdd, Dd, Dd, Dd, Dd, Dd, Dd, Dd, Dd, Dd, Dd, Dd, Dd, Mdd, Mdd, Mdd, Mdd, Mdd, Hd, Dd, Dd, Dd, Dd, Dd, Dd, Dd, Dd, Hd, Mdd, Mdd^Xm, Hd, Mdd^Xm, Dd, Cd, Dd, Dd, Dd, Dd, Dd, Dd, Dd, Dd, Dd, Dd, Dd
Dd, Dd, Dd, Dd, Dd, Dd, Hd, Mdd^Xm, Mdd, Hd, Dd^Ftd, Dd^Vda, Dd^Ftd, Dd^Ftd, Rd, Dd^Ftd, Hd, Dd^Ftd, Dd^Ftd, Wwt, Wwt, Wwt, Wwt, Rd, Dd^Ftd, Dd^Ftd, Rd, Dd^Ftd, Hd, Mdd, Mdd^Xm, Mdd^Xm, Mdd, Mdd, Mdd, Mdd, Dd, Dd, Dd, Dd, Dd, Dd, Dd, Dd, Dd, Dd, Dd, Dd, Dd, Dd, Hd, Mdd, Hd, Mdd, Mdd, Mdd, Dd, Dd, Mdd, Dd, Dd, Dd, Cd, Hd, Mdd, Mdd^Xm, Mdd, Mdd^Xm, Mdd, Cd, Cd, Cd, Mdd, Hd, Mdd^Xm, Dd, Dd, Dd, Dd, Dd, Dd, Dd
Dd, Dd, Dd, Dd, Dd, Dd, Mdd^Xm, Mdd, Mdd, Hd, Dd^Ftd, Dd, Rd, Rd, Dd^Ftd, Hd, Wwt, Dd^Ftd, Wwt, Wwt, Wwt, Wwt, Dd^Ftd, Rd, Rd, Rd, Dd^Ftd, Rd, Hd, Cd, Hd, Hd, Dd, Dd, Dd, Dd, Dd, Dd, Dd, Dd, Dd, Dd, Dd, Dd, Dd, Dd, Dd, Dd, Dd, Dd, Dd, Hd, Dd, Mdd, Hd, Hd, Mdd, Mdd^Xm, Mdd^Xm, Hd, Hd, Cd, Kd, Cd, Hd, Mdd, Mdd, Hd, Hd, Rd, Rd, Hd, Hd, Mdd^Xm, Mdd^Xm, Hd, Hd, Dd, Dd, Dd, Dd, Dd
Dd, Dd, Dd, Dd, Dd, Hd, Mdd, Mdd^Xm, Mdd, Dd^Ftd, Dd^Vda, Dd, Rd, Dd^Vda, Dd^Ftd, Dd^Ftd, Wwt, Wwt, Dd^Ftd, Wwt, Wwt, Dd^Ftd, Dd^Ftd, Rd, Dd^Vda, Dd^Ftd, Hd, Mdd^Xm, Mdd^Xm, Mdd^Xm, Hd, Dd, Dd, Dd, Dd, Dd, Dd, Dd, Dd, Dd, Dd, Dd, Dd, Dd, Dd, Dd, Dd, Dd, Dd, Dd, Dd, Dd, Dd, Dd, Dd, Hd, Hd, Mdd^Xm, Mdd^Xm, Mdd, Mdd, Cd, Rd, Rd, Hd, Hd, Dd, Dd^Vda, Wwt, Dd^Fts, Dd^Fts, Rd, Hd, Mdd, Mdd, Mdd, Cd, Dd, Hd, Dd, Dd, Dd
Dd, Dd, Dd, Dd, Dd, Hd, Mdd, Mdd, Hd, Hd, Dd^Ftd, Dd^Ftd, Rd, Dd^Ftd, Dd^Ftd, Wwt, Wwt, Dd^Ftd, Dd^Ftd, Wwt, Hd, Hd, Dd^Vda, Rd, Dd^Ftd, Hd, Mdd, Mdd, Mdd, Mdd^Xm, Mdd^Xm, Dd, Dd, Dd, Dd, Dd, Dd, Dd, Dd, Dd, Dd, Dd, Dd, Dd, Dd, Dd, Dd, Dd, Dd, Dd, Dd, Dd, Dd, Dd, Hd, Mdd^Xm, Mdd^Xm, Mdd, Mdd, Hd, Dd^Fts, Dd^Fts, Rd, Dd, Dd, Dd^Vda, Dd^Vda, Wwt, Wwt, Wwt, Dd^Fts, Rd, Dd, Dd^Vda, Dd^Vda, Cd, Cd, Hd, Mdd^Xm, Hd, Mdd, Dd
Dd, Dd, Dd, Dd, Dd, Dd, Hd, Mdd^Xm, Mdd, Dd^Vda, Rd, Rd, Dd^Ftd, Dd, Dd^Vda, Dd, Dd^Vda, Dd^Ftd, Dd, Dd^Vda, Dd, Hd, Dd^Ftd, Rd, Rd, Hd, Hd, Cd, Mdd^Xm, Mdd^Xm, Mdd, Mdd, Hd, Dd, Dd, Dd, Dd, Dd, Dd, Dd, Dd, Dd, Dd, Dd, Dd, Dd, Dd, Dd, Dd, Dd, Dd, Dd, Dd, Dd, Mdd, Mdd, Mdd, Mdd, Hd, Dd, Mdd, Dd^Fts, Rd, Dd^Vda, Dd^Fts, Dd^Fts, Hd, Hd, Dd^Vda, Dd, Rd, Rd, Rd, Hd, Rd, Rd, Rd, Mdd, Mdd^Xm, Mdd, Mdd, Mdd
Dd, Dd, Dd, Dd, Dd, Dd, Hd, Mdd^Xm, Mdd^Xm, Cd, Rd, Dd^Ftd, Dd^Ftd, Dd, Hd, Dd^Ftd, Dd^Ftd, Dd, Dd^Ftd, Dd, Dd^Ftd, Dd^Ftd, Hd, Hd, Cd, Rd, Kd, Cd, Cd, Mdd, Mdd, Hd, Dd, Dd, Dd, Dd, Dd, Dd, Dd, Dd, Dd, Dd, Dd, Dd, Dd, Dd, Dd, Dd, Dd, Dd, Mdd, Mdd^Xm, Mdd, Hd, Cd, Hd, Dd^Fts, Hd, Dd^Fts, Dd^Vda, Rd, Rd, Dd^Fts, Rd, Rd, Dd^Fts, Rd, Rd, Rd, Rd, Dd^Fts, Dd^Fts, Dd^Vda, Rd, Dd^Fts, Dd^Fts, Dd^Vda, Hd, Mdd^Xm, Mdd, Mdd, Mdd
Dd, Dd, Dd, Dd, Dd, Dd, Dd, Mdd, Mdd, Cd, Hd, Rd, Mdd, Mdd, Mdd, Hd, Mdd, Mdd^Xm, Mdd^Xm, Hd, Hd, Dd^Ftd, Mdd^Xm, Mdd^Xm, Mdd, Cd, Dd, Dd, Dd, Hd, Dd, Dd, Dd, Dd, Dd, Dd, Dd, Dd, Dd, Dd, Dd, Dd, Dd, Dd, Dd, Dd, Dd, Dd, Dd, Dd, Mdd, Mdd, Mdd^Xm, Hd, Mdd, Rd, Dd^Fts, Dd^Vda, Dd^Fts, Dd^Fts, Rd, Hd, Wwt, Dd^Vda, Dd^Fts, Rd, Cd, Cd, Cd, Rd, Dd^Vda, Mdd, Mdd, Rd, Hd, Dd^Fts, Hd, Mdd, Mdd, Mdd^Xm, Mdd^Xm, Mdd
Dd, Dd, Dd, Dd, Dd, Dd, Dd, Dd, Hd, Mdd, Hd, Cd, Cd, Hd, Mdd^Xm, Mdd^Xm, Mdd^Xm, Mdd, Mdd^Xm, Mdd, Mdd, Mdd, Mdd, Mdd^Xm, Mdd, Cd, Dd, Dd, Dd, Dd, Dd, Dd, Dd, Dd, Dd, Dd, Dd, Dd, Dd, Dd, Dd, Dd, Dd, Dd, Dd, Dd, Dd, Dd, Dd, Dd, Mdd, Mdd, Mdd, Mdd^Xm, Mdd, Rd, Rd, Mdd, Rd, Rd, Rd, Dd^Fts, Wwt, Wwt, Dd^Fts, Rd, Cd, Kd, Cd, Rd, Dd^Vda, Dd^Fts, Dd^Fts, Rd, Dd^Vda, Dd^Vda, Hd, Hd, Mdd, Mdd^Xm, Mdd, Mdd
Dd, Dd, Dd, Dd, Dd, Dd, Dd, Dd, Dd, Hd, Dd, Dd, Dd, Mdd^Xm, Mdd, Mdd, Mdd, Mdd^Xm, Mdd, Mdd^Xm, Mdd^Xm, Mdd, Mdd^Xm, Mdd^Xm, Mdd, Mdd, Dd, Dd, Dd, Dd, Dd, Dd, Dd, Dd, Dd, Dd, Dd, Dd, Dd, Dd, Dd, Dd, Dd, Dd, Dd, Dd, Dd, Dd, Dd, Dd, Mdd, Mdd, Mdd, Mdd^Xm, Hd, Dd^Vda, Dd^Fts, Rd, Dd^Vda, Hd, Rd, Dd^Fts, Hd, Dd^Vda, Rd, Rd, Rd, Cd, Rd, Rd, Rd, Dd^Fts, Rd, Rd, Hd, Dd^Fts, Dd^Fts, Hd, Mdd^Xm, Mdd^Xm, Mdd, Mdd
Dd, Dd, Dd, Dd, Dd, Dd, Dd, Dd, Dd, Dd, Dd, Dd, Dd, Dd, Dd, Mdd, Mdd, Mdd, Hd, Hd, Hd, Mdd^Xm, Hd, Hd, Dd, Dd, Dd, Dd, Dd, Dd, Dd, Dd, Dd, Dd, Dd, Dd, Dd, Dd, Dd, Dd, Dd, Dd, Dd, Dd, Dd, Dd, Dd, Dd, Dd, Dd, Hd, Mdd^Xm, Mdd^Xm, Mdd, Hd, Dd^Fts, Dd^Fts, Rd, Dd^Vda, Dd, Dd^Fts, Rd, Rd, Rd, Dd^Vda, Hd, Dd^Vda, Rd, Hd, Dd^Vda, Dd^Fts, Rd, Rd, Dd, Dd^Vda, Dd^Fts, Mdd, Mdd^Xm, Mdd^Xm, Mdd, Mdd, Mdd
Dd, Dd, Dd, Dd, Dd, Dd, Dd, Dd, Dd, Dd, Dd, Dd, Dd, Dd, Dd, Dd, Dd, Dd, Dd, Dd, Dd, Dd, Dd, Dd, Dd, Dd, Dd, Dd, Dd, Dd, Dd, Dd, Dd, Dd, Dd, Dd, Dd, Dd, Dd, Dd, Dd, Dd, Dd, Dd, Dd, Dd, Dd, Dd, Dd, Dd, Dd, Hd, Mdd, Hd, Dd^Vda, Dd, Rd, Rd, Rd, Dd^Fts, Rd, Rd, Rd, Dd^Vda, Hd, Dd^Fts, Dd^Fts, Rd, Hd, Wwt, Wwt, Dd^Fts, Rd, Dd^Vda, Hd, Hd, Mdd, Mdd^Xm, Mdd, Mdd, Hd, Mdd
Dd, Dd, Dd, Dd, Dd, Dd, Dd, Dd, Dd, Dd, Dd, Dd, Dd, Dd, Dd, Dd, Dd, Dd, Dd, Dd, Dd, Dd, Dd, Dd, Dd, Dd, Dd, Dd, Dd, Dd, Dd, Dd, Dd, Dd, Dd, Dd, Dd, Dd, Dd, Dd, Dd, Dd, Dd, Dd, Dd, Dd, Dd, Dd, Dd, Dd, Dd, Hd, Hd, Cd, Kd, Rd, Mdd, Hd, Mdd^Xm, Rd, Dd^Vda, Dd^Fts, Rd, Hd, Dd^Vda, Dd^Fts, Rd, Rd, Dd^Fts, Wwt, Hd, Dd^Vda, Rd, Dd, Mdd^Xm, Hd, Mdd, Mdd, Hd, Hd, Dd, Dd
Dd, Dd, Dd, Dd, Dd, Dd, Dd, Dd, Dd, Dd, Dd, Dd, Dd, Dd, Dd, Dd, Dd, Dd, Dd, Dd, Dd, Dd, Dd, Dd, Dd, Dd, Dd, Dd, Dd, Dd, Dd, Dd, Dd, Dd, Dd, Dd, Dd, Dd, Dd, Dd, Dd, Dd, Dd, Dd, Dd, Dd, Dd, Dd, Dd, Dd, Dd, Dd, Dd, Cd, Cd, Cd, Mdd, Mdd^Xm, Mdd^Xm, Mdd, Hd, Dd^Fts, Dd^Vda, Rd, Rd, Rd, Dd^Fts, Hd, Dd^Vda, Dd^Fts, Hd, Dd^Fts, Hd, Mdd^Xm, Mdd, Mdd, Mdd, Mdd, Dd, Dd, Dd, Dd
Dd, Dd, Dd, Dd, Dd, Dd, Dd, Dd, Dd, Dd, Dd, Dd, Dd, Dd, Dd, Dd, Dd, Dd, Dd, Dd, Dd, Dd, Dd, Dd, Dd, Dd, Dd, Dd, Dd, Dd, Dd, Dd, Dd, Dd, Dd, Dd, Dd, Dd, Dd, Dd, Dd, Dd, Dd, Dd, Dd, Dd, Dd, Dd, Dd, Dd, Dd, Dd, Dd, Dd, Dd, Mdd, Mdd, Mdd, Mdd^Xm, Mdd^Xm, Mdd, Hd, Kd, Cd, Rd, Hd, Dd^Fts, Dd^Fts, Hd, Mdd, Mdd^Xm, Hd, Cd, Mdd, Hd, Mdd, Hd, Dd, Dd, Dd, Dd, Dd
Dd, Dd, Dd, Dd, Dd, Dd, Dd, Dd, Dd, Dd, Dd, Dd, Dd, Dd, Dd, Dd, Dd, Dd, Dd, Dd, Dd, Dd, Dd, Dd, Dd, Dd, Dd, Dd, Dd, Dd, Dd, Dd, Dd, Dd, Dd, Dd, Dd, Dd, Dd, Dd, Dd, Dd, Dd, Dd, Dd, Dd, Dd, Dd, Dd, Dd, Dd, Dd, Dd, Dd, Dd, Dd, Dd, Hd, Hd, Mdd^Xm, Hd, Cd, Cd, Cd, Mdd^Xm, Mdd, Mdd^Xm, Hd, Mdd, Mdd^Xm, Mdd^Xm, Hd, Rd, Hd, Dd, Hd, Dd, Dd, Dd, Dd, Dd, Dd
Dd, Dd, Dd, Dd, Dd, Dd, Dd, Dd, Dd, Dd, Dd, Dd, Dd, Dd, Dd, Dd, Dd, Dd, Dd, Dd, Dd, Dd, Dd, Dd, Dd, Dd, Dd, Dd, Dd, Dd, Dd, Dd, Dd, Dd, Dd, Dd, Dd, Dd, Dd, Dd, Dd, Dd, Dd, Dd, Dd, Dd, Dd, Dd, Dd, Dd, Dd, Dd, Dd, Dd, Dd, Dd, Dd, Dd, Dd, Dd, Dd, Dd, Dd, Mdd, Hd, Mdd^Xm, Mdd^Xm, Mdd, Mdd^Xm, Mdd, Hd, Dd, Dd, Rd, Dd, Dd, Dd, Dd, Dd, Dd, Dd, Dd
Dd, Dd, Dd, Dd, Dd, Dd, Dd, Dd, Dd, Dd, Dd, Dd, Dd, Dd, Dd, Dd, Dd, Dd, Dd, Dd, Dd, Dd, Dd, Dd, Dd, Dd, Dd, Dd, Dd, Dd, Dd, Dd, Dd, Dd, Dd, Dd, Dd, Dd, Dd, Dd, Dd, Dd, Dd, Dd, Dd, Dd, Dd, Dd, Dd, Dd, Dd, Dd, Dd, Dd, Dd, Dd, Dd, Dd, Dd, Dd, Dd, Dd, Dd, Hd, Hd, Mdd^Xm, Hd, Mdd^Xm, Mdd, Hd, Dd, Dd, Dd, Dd, Rd, Dd, Dd, Dd, Dd, Dd, Dd, Dd
Dd, Dd, Dd, Dd, Dd, Dd, Dd, Dd, Dd, Dd, Dd, Dd, Dd, Dd, Dd, Dd, Dd, Dd, Dd, Dd, Dd, Dd, Dd, Dd, Dd, Dd, Dd, Dd, Dd, Dd, Dd, Dd, Dd, Dd, Dd, Dd, Dd, Dd, Dd, Dd, Dd, Dd, Dd, Dd, Dd, Dd, Dd, Dd, Dd, Dd, Dd, Dd, Dd, Dd, Dd, Dd, Dd, Dd, Dd, Dd, Dd, Dd, Dd, Hd, Dd, Dd, Dd, Hd, Dd, Dd, Dd, Dd, Dd, Dd, Dd, Rd, Dd, Rd, Rd, Dd, Dd, Dd
