Gg, Gll^Fp, Gs^Fms, Gll^Fmw, Gg, Gll^Fp, Gg, Gg, Gg, Gll^Fp, Gs^Fds, Gll^Fp, Gll^Fp, Gg, Gll, Gg, Gg, Gg, Gg^Fet, Gs^Fms, Gg, Gll^Fp, Gg, Gll, Gg, Gs^Fms, Gg, Gll^Fp, Gg, Gg, Gll^Fp, Gg, Gll, Gg, Gg, Gg, Gll^Fp, Gg, Gll^Fp, Gg, Gll, Gg, Gs^Fms, Gg, Gg, Gll, Gg, Gg, Gg, Gll^Fp, Dd, Hd, Dd, Dd^Edp, Dd, Ds, Dd^Ftd, Dd^Edpp, Ds, Dd, Ds, Dd, Dd, Ds, Dd, Dd, Ds, Ds, Dd, Dd^Edpp, Dd, Hd
Gg, Gs^Fms, Gg, Gs^Fms, Ce, Gg, Gll^Fmw, Gg, Ce, Gg, Gll^Fp, Gll^Fp, Ce, Gg, Gg, Gg, Gs^Fds, Gg, Gg, Gll^Fp, Gs^Fds, Gs^Fds, Gg, Gg, Gg, Gg, Gll, Gg, Gg, Gg, Gs^Fds, Gg, Gll^Fp, Gg, Gg, Gg, Gg, Gg, Gg, Gg, Gg, Gg, Gg, Gg, Gg, Gg, Gs^Fds, Gg, Gg, Gll^Fp, Dd, Ds, Dd, Dd, Dd, Dd, Dd, Dd, Dd, Dd, Dd, Dd, Dd, Dd, Dd, Dd^Edp, Dd, Dd, Ds, Dd, Hd, Dd
Gg, Gll^Fp, Gg, Ce, Ke, Ce, Ce, Ce, Ke, Ce, Ce, Ce, Ke, Ce, Gll^Fp, Gll^Fp, Gs^Fms, Gg, Gs^Fms, Gs^Fms, Gs^Fms, Gg, Gll^Fp, Gll, Gs^Fms, Gg, Gg, Gs^Fds, Gll, Gg, Gg, Gg, Gll, Gg, Gg, Gll, Gg, Gg, Gll^Fp, Gs^Fms, Gll, Gg, Gll^Fp, Gg, Gg, Gg, Gll, Gll^Fp, Rr, Gg, Gg, Dd^Esd, Dd^Edpp, Dd^Edpp, Dd, Dd^Edp, Dd, Dd, Dd, Dd, Dd, Dd^Ftd, Dd, Dd, Ds, Dd, Dd, Dd^Esd, Ds, Dd^Ftd, Dd, Dd^Esd
Gg, Gg, Gll^Fp, Ce, Ce, Ce, Gll^Fp, Ce, Ce, Ce, Gg, Ce, Ce, Ce, Gs^Fms, Gg, Gll^Fp, Gs, Gs^Fms, Gs^Fms, Gs^Fms, Gg, Gg, Gg, Gg, Gg, Gg, Gll^Fp, Gg, Gg, Gg, Gg, Gg, Gs^Fms, Gll^Fp, Gg, Gg, Gs^Fds, Gll, Gg, Gg, Gg, Gll^Fp, Gs^Fds, Gg, Gg, Rr, Rr, Cydy, Rr, Rr, Dd, Dd, Dd, Dd^Esd, Dd^Edpp, Dd^Edp, Dd^Esd, Dd, Hd, Dd^Ftd, Dd^Edp, Dd, Ds, Dd, Dd, Dd, Ds, Dd, Dd, Dd^Esd, Dd
Gg, Gll^Fp, Gg, Gll^Fp, Gs^Fms, Gs^Fds, Gg, Gll^Fmw, Gg, Gg, Gll^Fp, Gg, Gg, Gs^Fds, Gll, Gs^Fms, Gg, Gg, Gg, Gs^Fms, Gg, Gg, Gs^Fds, Gg, Gs^Fms, Gg, Gg, Gll, Gg, Gg, Gg, Gg, Gll, Gg, Gg, Gs^Fms, Gg, Gll, Gg, Gg, Gg, Gll^Fp, Gg, Gg, Ce, Gg, Rr, Cydy, Kydy, Cydy, Rr, Dd, Dd, Dd, Dd, Dd, Dd, Dd, Dd, Dd^Edp, Dd, Dd^Ftd, Dd, Hd, Hd, Dd^Edp, Dd, Dd^Edp, Dd^Esd, Dd, Ds, Dd
Gs^Fms, Gg, Gll^Fp, Gs^Fds, Gs^Fds, Gll^Fp, Gll^Fp, Gg, Gll, Gg, Gg, Gg^Fet, Gg, Gll^Fp, Gg, Gg, Gg, Gg, Gll^Fp, Gg, Gg, Gg, Gg, Gg, Gll^Fp, Gg, Gg, Gg, Gll^Fp, Gg, Gg, Gg, Gg, Gg, Gll, Gg, Gg, Gg, Gg, Gg, Gg, Gg, Gg, Ce, Gg, Gg, Rr, Cydy, Cydy, Cydy, Rr, Hd, Dd^Edp, Dd, Hd, Dd, Ds, Dd, Dd, Dd, Dd, Dd, Dd^Ftd, Dd, Ds, Dd^Ftd, Dd, Dd, Dd, Dd^Ftd, Ds, Dd^Ftd
Gg^Fet, Gg, Gg, Gll^Fp, Gg, Gll^Fp, Gg, Gg, Gg, Gs^Fms, Gg^Fet, Gg, Gg, Gg, Gg, Gg, Gs^Fms, Gs^Fds, Gg, Gs^Fms, Gg, Gg, Gg, Gs^Fms, Gg, Gs^Fds, Gll, Gg, Gg, Gs^Fms, Gg, Gg, Gll, Gg, Gll, Gg, Gg, Gg, Gg, Gg, Ce, Ce, Gg, Gg, Rb^Eff, Rb^Eff, Rb^Eff, Rr, Rr, Rr, Ce, Dd, Dd, Dd, Dd, Dd, Dd, Dd, Dd, Ds, Dd^Ftd, Dd, Dd, Dd, Dd, Dd^Edp, Ds, Dd, Dd, Dd^Esd, Dd^Edpp, Dd
Gg, Gll^Fp, Gs^Fms, Gll^Fp, Gg, Gs^Fds, Gs^Fds, Gll^Fp, Gg, Gg, Gg, Gll, Gg, Gg, Gg, Gg, Gg, Gg, Gg, Gll^Fp, Gg, Gll, Gs^Fms, Gg, Gg, Gs^Fds, Gg, Gg, Gll^Fp, Gg, Gg, Gg, Gg, Gg, Gs^Fms, Gg, Gg, Gg, Ce, Gg, Gg, Gg, Rb^Eff, Rb^Eff, Re^Gvs, Re^Gvs, Re^Gvs, Rb^Eff, Rb^Eff, Gg, Gs^Vc, Ce, Gg, Dd, Dd, Dd, Dd, Dd, Dd^Esd, Dd, Dd, Hd, Dd, Dd, Dd, Dd, Hd, Ds, Dd, Dd, Dd, Ds
Gg, Gg, Gg, Gg, Gll^Fp, Gll^Fp, Gs^Fms, Gll^Fp, Gg, Gg, Gg, Gll^Fp, Gll^Fp, Gll^Fp, Gg, Gg, Gg, Gll^Fp, Gll, Gll, Gs^Fds, Gg, Gg, Gg, Gg, Gg, Gs^Fds, Gg, Gg, Gs^Fms, Gll^Fp, Gg, Gg, Gg, Gg, Gll^Fp, Gg, Ce, Gg, Gg, Rb^Eff, Rb^Eff, Re^Gvs, Re^Gvs, Re^Gvs, Re^Gvs, Re^Gvs, Re^Gvs, Re^Gvs, Rb^Eff, Rb^Eff, Gg, Gg, Ce, Dd, Dd^Ftd, Dd, Dd, Dd, Hd, Dd^Esd, Dd, Dd, Dd, Dd, Dd^Ftd, Dd^Edpp, Hd, Dd^Edp, Dd, Dd^Ftd, Dd
Gll^Fp, Gg, Gg, Gll^Fp, Gll^Fp, Gg, Gs^Fms, Gll^Fp, Gg, Gg, Gg, Gs^Fds, Gs^Fms, Gs^Fms, Gll^Fp, Gg, Gs^Fms, Gg, Gs^Fds, Gg, Gs^Fms, Gs^Fms, Gg, Gg, Gg, Gg, Gg, Gg, Gg, Gg, Gg, Gg, Gg, Gg, Ce, Ce, Gg, Gg, Rb^Eff, Rb^Eff, Re^Gvs, Re^Gvs, Re^Gvs, Re^Gvs, Re^Gvs, Re^Gvs, Re^Gvs, Re^Gvs, Re^Gvs, Re^Gvs, Re^Gvs, Rb^Eff, Rb^Eff, Gg, Ce, Dd^Esd, Hd, Ds, Dd, Dd, Dd, Dd, Dd, Dd^Esd, Hd, Dd, Dd^Esd, Dd, Dd^Edp, Dd, Dd^Esd, Dd^Edp
Gg, Gll^Fp, Gll^Fp, Gg, Gll^Fp, Gs^Fds, Gg, Gg, Gg, Gg, Gg, Gg, Gg, Gll^Fp, Gs^Fms, Gg, Gs^Fds, Gg, Gll, Gg, Gg, Gll, Gg, Gg, Gg, Gg, Rr, Rr, Rr, Gg, Gs^Fms, Gg, Ce, Gg, Gg, Gg, Rb^Eff, Rb^Eff, Re^Wm, Rb^Eff, Rb^Eff, Re^Gvs, Re^Gvs, Re^Gvs, Re^Gvs, Re^Gvs, Re^Gvs, Re^Gvs, Re^Gvs, Re^Gvs, Re^Gvs, Re^Gvs, Re^Wm, Rb^Eff, Rb^Eff, Ce, Ds, Dd^Dc, Dd, Dd, Dd, Dd^Edpp, Ds, Dd, Dd, Dd^Esd, Dd, Dd^Esd, Dd^Esd, Dd, Dd, Dd
Gll^Fp, Gs^Fms, Gg, Gg, Gs^Fms, Gg, Gll^Fp, Gg, Gll^Fp, Gg, Gll^Fp, Gg, Gg, Gg, Gg, Gg, Gg, Gs^Fms, Gg, Gg, Gg, Gll^Fp, Gg, Gg, Gg, Rr, Cydy, Cydy, Cydy, Rr, Gg, Ce, Gg, Gg, Rb^Eff, Rb^Eff, Re^Gvs, Re^Gvs, Re^Gvs, Re^Gvs, Re^Gvs, Rb^Eff, Rb^Eff, Re^Gvs, Re^Gvs, Re^Gvs, Re^Gvs, Re^Gvs, Re^Gvs, Re^Gvs, Re^Gvs, Re^Gvs, Rb^Eff, Rb^Eff, Gg, Ce, Dd, Ds, Dd, Hd, Hd, Dd^Edp, Ds, Dd^Edp, Dd, Dd^Ftd, Dd, Dd, Dd, Ds, Dd, Dd
Gll^Fp, Gg, Gg^Fet, Gll^Fp, Gll^Fp, Gll^Fp, Gg, Gll^Fp, Gg, Gg, Gg, Gll^Fp, Gll^Fp, Gg, Gg, Gg, Gg, Gg, Gg, Gll^Fp, Gs^Fms, Gs^Fds, Gg, Gg, Gll^Fp, Rr, Cydy, Kydy, Cydy, Rr, Gg, Gg, Rb^Eff, Rb^Eff, Re^Gvs, Re^Gvs, Re^Gvs, Re^Gvs, Re^Gvs, Re^Gvs, Re^Gvs, Re^Gvs, Re^Gvs, Rb^Eff, Rb^Eff, Re^Gvs, Re^Gvs, Re^Gvs, Re^Gvs, Re^Gvs, Rb^Eff, Rb^Eff, Gg, Gs^Vc, Ce, Dd, Dd, Dd^Esd, Dd, Dd, Dd, Dd, Dd, Hd, Dd, Dd, Dd, Dd^Esd, Dd^Edpp, Dd^Esd, Dd, Dd
Gs^Fds, Gs^Fds, Gg, Gll^Fp, Gg, Gg, Gll^Fp, Gll^Fp, Gs^Fds, Gll^Fp, Gg, Gll^Fp, Gg, Gll^Fp, Gg, Gg, Gll^Fp, Gg, Gg, Gg, Gg, Gg, Gg, Gg, Gg, Rr, Rr, Cydy, Rr, Rr, Rb^Eff, Rb^Eff, Re^Gvs, Re^Gvs, Re^Gvs, Re^Gvs, Re^Gvs, Re^Gvs, Re^Gvs, Re^Gvs, Re^Gvs, Re^Gvs, Re^Gvs, Re^Gvs, Re^Gvs, Rb^Eff, Rb^Eff, Re^Gvs, Rb^Eff, Rb^Eff, Gg, Gg, Cydy, Gg, Gg, Dd, Dd^Edp, Dd^Edpp, Ds, Dd, Dd^Edpp, Dd, Dd, Dd^Edp, Dd, Hd, Dd^Ftd, Dd, Dd, Dd, Dd, Dd
Gg, Gll^Fp, Gs^Fds, Gg, Gg, Gg, Gg, Gg, Gg, Gll^Fp, Gll^Fp, Gll^Fp, Gs^Fms, Gll^Fp, Gg, Gs^Fds, Gg, Gg, Gg, Gg, Gg, Gg, Gg, Gll^Fp, Gg, Gg, Gg, Rr, Gg, Rb^Eff, Rb^Eff, Re^Gvs, Re^Gvs, Re^Gvs, Re^Gvs, Re^Gvs, Re^Gvs, Re^Gvs, Re^Gvs, Re^Gvs, Re^Gvs, Re^Gvs, Re^Gvs, Re^Gvs, Re^Gvs, Re^Gvs, Rb^Eff, Rb^Eff, Gg, Gg, Gs^Vc, Cydy, Kydy, Cydy, Gg, Dd, Dd, Dd, Dd, Dd^Edpp, Dd, Ds, Dd, Dd, Dd^Edp, Hd, Hd, Dd^Edp, Dd^Ftd, Dd^Edp, Dd, Dd
Gg, Gg, Gg, Gg, Gll^Fp, Gg, Gll^Fp, Gll^Fp, Gll^Fp, Gg, Gll^Fp, Gll^Fp, Gg, Gg, Gg, Gs^Fds, Gll^Fp, Gs^Fds, Gs^Fms, Gll^Fp, Gg, Gll^Fp, Gg, Gll^Fp, Gg, Gg, Gg, Gg, Ce, Gg, Gg, Rb^Eff, Rb^Eff, Re^Gvs, Re^Gvs, Re^Gvs, Re^Gvs, Re^Gvs, Re^Gvs, Re^Gvs, Re^Gvs, Re^Gvs, Re^Gvs, Re^Gvs, Rb^Eff, Rb^Eff, Gg, Gg, Gs^Vc, Gg, Gg, Cydy, Cydy, Cydy, Gg, Ce, Ce, Dd, Dd^Edp, Dd, Dd, Dd, Dd, Dd, Dd^Ftd, Dd^Edpp, Dd, Dd^Ftd, Dd, Dd, Dd, Dd^Edp
Gg, Gll^Fp, Gg, Gg, Gll^Fp, Gg, Gg, Gg, Gll^Fp, Gll^Fp, Gg, Gg, Gg, Gll^Fmw, Gg, Gg, Gll^Fp, Gs^Fms, Gg, Gg, Gll^Fp, Gg, Gll^Fp, Gg, Gg, Gll^Fp, Gg, Gg, Gg, Ce, Gg, Gg, Gg, Rb^Eff, Rb^Eff, Re^Gvs, Re^Gvs, Re^Gvs, Re^Gvs, Re^Gvs, Re^Gvs, Re^Gvs, Rb^Eff, Rb^Eff, Gg, Gs^Vc, Gg, Gg, Gg, Gg, Rr, Gg, Rr, Rr, Rr, Gg, Rr, Rr, Ds, Dd^Edpp, Dd, Dd^Edp, Dd^Edp, Ds, Dd, Dd^Esd, Dd^Ftd, Dd, Dd, Ds, Dd, Dd^Esd
Gs^Fms, Gs^Fds, Gg, Gll^Fp, Gs^Fds, Gll^Fp, Gll^Fp, Gg, Gg, Gg, Gg, Gs^Fms, Gg, Gg, Gg, Gll^Fp, Gg, Gs^Fms, Gs^Fms, Gg, Gs^Fms, Gll^Fmw, Gs^Fds, Gg, Gg, Gll^Fp, Gg, Gg, Gll^Fp, Gg, Gg, Ce, Ce, Gg, Gg, Rb^Eff, Rb^Eff, Re^Gvs, Re^Gvs, Re^Gvs, Rb^Eff, Rb^Eff, Rr, Rr, Rr, Gg, Rr, Rr, Rr, Rr, Ds, Rr, Ds, Ds, Ds, Rr, Ds, Ds, Ds, Ds, Ds, Dd, Dd, Dd, Dd, Ds, Dd, Dd, Dd^Edp, Dd, Dd, Ds
Gg, Gll^Fp, Gg, Gll^Fp, Gg, Gll^Fp, Gll^Fp, Gll^Fp, Gg, Gll^Fmw, Gll^Fp, Gg, Gll^Fp, Gg, Gg, Gs^Fms, Gg, Gg, Gll^Fmw, Gll^Fp, Gll^Fp, Gg, Gg, Gg, Gll^Fp, Gg, Gg, Gll^Fp, Gs^Fds, Gg, Gg, Gll^Fp, Gll^Fp, Gll^Fp, Gll^Fp, Gg, Gg, Rb^Eff, Rb^Eff, Rb^Eff, Rr, Rr, Ds, Ds, Ds, Rr, Ds, Ds, Wwt, Ds, Wwt, Wwt^Bsb|, Wwt, Wwt, Wwt, Wwt^Bsb|, Ww, Ww, Ww, Ww, Ww, Dd, Dd, Dd^Esd, Dd^Edpp, Dd, Dd, Dd, Dd, Dd^Esd, Dd^Esd, Dd
Gll^Fp, Gg, Gll^Fp, Gg, Gg, Gll^Fp, Gll^Fp, Gll^Fp, Gll^Fp, Gg, Gg, Gg, Gg, Gll^Fp, Gs^Fds, Gg, Gg, Gll^Fp, Gll^Fp, Gll^Fp, Gg, Gg, Gg, Gg, Gg, Gll^Fp, Gg, Gg, Gll^Fp, Gll^Fp, Gg, Gg, Gll^Fp, Gll^Fp, Gs^Fds, Gll^Fp, Cydy, Gg, Rr, Rr, Gs^Vc, Ds, Wwt, Wwt, Wwt, Wwt^Bsb|, Wwt, Wwt, Cydy, Wwt, Cydy, Wwt^Bsb|, Cydy, Wwt, Cydy, Wwt^Bsb|, Cydy, Cydy, Cydy, Ww, Xos, Xos, Xos, Hd, Xos, Dd, Dd, Dd, Xos, Dd^Ftd, Dd^Edpp, Dd^Edp
Gg, Gg, Gll^Fp, Gll^Fp, Gg, Gg, Gs^Fds, Gg, Gg, Gll^Fp, Gs^Fms, Gs^Fms, Gll^Fp, Gll^Fp, Gll^Fp, Gg, Gll^Fmw, Gll^Fp, Gll^Fp, Gs^Fms, Gg, Gg, Gll^Fp, Gg, Gg, Gg, Gll^Fp, Gg, Gg, Gll^Fp, Gll^Fp, Gll^Fp, Gg, Gs^Fds, Gg, Gg, Cydy, Kydy, Cydy, Gg, Wwt, Wwt, Cydy, Cydy, Cydy, Wwt^Bsb|, Cydy, Cydy, Rr, Rr, Rr, Rr, Rr, Rr, Rr, Rr, Rr, Cydy, Wwb, Wwbf, Wwb, Xos, Xos, Xos, Xos, Xos, Xos, Xos, Xos, Xos, Xos, Xos
Gg, Gll^Fp, Gg, Gg, Gg, Gll^Fp, Gll^Fp, Gg, Gg, Gg, Gll^Fp, Gll^Fp, Gll^Fp, Gs^Fds, Gg, Gg, Gs^Fds, Gll^Fp, Gll^Fp, Gll^Fp, Gg, Gg, Gll^Fp, Gg, Gg, Gll^Fp, Gg, Gg, Gll^Fmw, Gg, Gll^Fp, Gg, Gg, Gll^Fp, Gll^Fp, Gll^Fp, Gll^Fp, Cydy, Ds, Wwt, Cydy, Cydy, Rr, Cydy, Rr, Rr, Rr, Rr, Rr^Rhx, Rr^Vhc, Rr^Rhx, Rr^Rhx, Rr, Rr^Rhx, Rr^Rhx, Rr^Rhx, Rr^Rhx, Rr, Rr, Wwb, Wwb, Wwb, Wwb, Wwb, Wwb, Xos, Xos, Xos, Xos, Xos, Xos, Xos
Gll^Fp, Gg, Ce, Ce, Ce, Gg, Gs^Fds, Gll^Fp, Gg, Gg, Gg, Gs^Fms, Gg, Gll^Fp, Gg, Gg, Gg, Gg, Gg, Gg, Gll^Fp, Gg, Gg, Gll^Fp, Gll^Fp, Gg, Gg, Gs^Fms, Gg, Gg, Gg, Gs^Fms, Gg, Gll^Fp, Gll^Fp, Gll^Fp, Gs^Fms, Gll^Fp, Ds, Wwt, Cydy, Cydy, Rr, Rr, Rr^Rhx, Rr^Rhx, Rr^Rhx, Rr^Rhx, Rr^Rhx, Rr^Rhx, Rr^Rhx, Rr^Rhx, Rr, Rr^Rhx, Rr^Rhx, Rr^Rhx, Rr^Rhx, Rr^Vhc, Rr^Rhx, Rr, Rr, Wwb, Wwb, Wwb, Wwb, Wwb, Wwb, Wwb, Wwb, Xos, Xos, Xos
Gs^Fds, Gg, Ce, Ce, 1 Ke, Ce, Ce, Gg, Gll^Fp, Gg, Gg, Gg, Gs^Fds, Gll^Fp, Gg, Gll^Fp, Gll^Fmw, Gll^Fp, Gg, Gll^Fp, Gll^Fmw, Gg, Gll^Fp, Gg, Gll^Fp, Gg, Gll^Fp, Gll^Fp, Gll^Fp, Gg, Gll^Fp, Gll^Fp, Gll^Fp, Gg, Gg, Gg, Gg, Ds, Wwt, Wwt, Cydy, Rr, Rr^Rhx, Rr, Rr, Rr^Rhx, Rr^Rhx, Rr^Rhx, Rr^Rhx, Rr^Rhx, Rr^Rhx, Rr^Rhx, Cydy, Rr^Vhc, Rr^Rhx, Rr^Rhx, Rr^Rhx, Rr^Rhx, Rr^Rhx, Rr^Rhx, Rr^Rhx, Rr, Rr, Rr, Rr, Wwb, Wwb, Wwb, Wwb, Wwb, Xos, Xos
Gll^Fp, Gg, Gg, Ce, Ce, Ce, Ce, Gg, Gg, Gll^Fp, Gll^Fp, Gg, Gs^Fds, Gg, Gll^Fp, Gll^Fp, Gll^Fp, Gs^Fms, Gll^Fp, Gll^Fp, Gg, Gll^Fp, Gg, Gs^Fds, Gg, Gg, Gll^Fp, Gs^Fds, Gll^Fp, Gll^Fp, Gg, Gg, Gg, Gll^Fp, Gll^Fp, Gll^Fp, Gg, Ds, Wwt, Cydy, Cydy, Rr, Rr^Rhx, Rr^Rhx, Rr^Rhx, Rr, Rr, Rr, Rr, Rr^Vhc, Rr, Cydy, Kydy, Cydy, Rr^Vhc, Rr^Rhx, Rr^Rhx, Rr^Rhx, Rr^Vhc, Rr^Rhx, Rr^Rhx, Rr^Rhx, Rr, Rr, Cydy, Kydy, Cydy, Wwb, Wwb, Wwb, Xos, Xos
Gll^Fp, Gll^Fp, Gll^Fp, Gg, Gg, Ce, Gg, Gll^Fp, Gg, Gg, Gg, Gg, Gg, Gg, Gll^Fp, Gg, Gs^Fms, Gg, Gll^Fp, Gg, Gll^Fp, Gll^Fp, Gg, Gll^Fp, Gg, Gll^Fp, Gll^Fp, Gll^Fp, Gs^Fds, Gs^Fds, Gll^Fmw, Gll^Fp, Gll^Fp, Gg, Rr, Rr, Rr, Gs^Vc, Wwt, Cydy, Rr, Rr, Rr^Rhx, Rr^Rhx, Rr^Rhx, Rr^Vhc, Rr, Rr^Vhc, Rr^Rhx, Rr, Rr^Rhx, Cydy^Ebn, Cydy, Cydy, Rr, Rr^Rhx, Rr^Rhx, Rr^Rhx, Rr^Rhx, Rr^Rhx, Rr^Rhx, Rr^Rhx, Rr, Kydy, Cydy, Cydy, Cydy, Kydy, Wwb, Wwb, Xos, Xos
Gg, Gg, Gll^Fp, Gll^Fp, Gg, Gll^Fp, Gs^Fds, Gg, Gg, Gll^Fp, Gg, Gll^Fp, Gll^Fp, Gg, Gs^Fms, Gg, Gll^Fp, Gll^Fp, Gll^Fp, Gg^Fet, Gg, Gg, Gll^Fp, Gll^Fmw, Gll^Fp, Gll^Fp, Gll^Fp, Gg, Gs^Fms, Gs^Fms, Gg, Gs^Fds, Gs^Fms, Rr, Cydy, Cydy, Cydy, Rr, Wwt^Bsb/, Rr, Rr, Rr^Rhx, Rr^Rhx, Rr^Rhx, Rr^Rhx, Rr^Rhx, Rr, Rr^Rhx, Rr^Rhx, Rr^Rhx, Rr^Rhx, Rr, Wwb, Wwb, Wwb, Rr, Rr^Rhx, Rr^Rhx, Rr^Rhx, Rr^Rhx, Rr, Rr^Rhx, Rr, Cydy, Cydy, Kydy, Cydy, Cydy, Wwb, Wwb, Xos, Xos
Gll^Fp, Gll^Fp, Gg, Gg, Gll^Fmw, Gll^Fp, Gg, Gll^Fp, Gll^Fp, Gll^Fp, Gll^Fp, Gs^Fds, Gg, Gll^Fp, Gg, Gg, Gll^Fp, Gg, Gll^Fp, Gs^Fds, Gll^Fp, Gg, Gll^Fp, Gs^Fms, Gg, Gg, Gll^Fp, Gg, Gg, Gll^Fp, Gll^Fp, Gs^Fds, Gg, Rr, Cydy, Kydy, Cydy, Rr, Wwt, Cydy, Cydy, Rr, Rr^Vhc, Rr^Rhx, Rr, Rr^Rhx, Rr, Rr^Vhc, Rr^Rhx, Rr^Rhx, Rr^Rhx, Rr, Wwb, Wwb, Wwb, Rr, Rr^Vhc, Rr^Rhx, Rr^Rhx, Rr, Rr^Rhx, Rr, Rr, Kydy, Cydy, Cydy, Cydy, Kydy, Wwb, Wwb, Xos, Xos
Gg, Gg, Gll^Fp, Gs^Fds, Gg, Gs^Fms, Gg, Gs^Fms, Gg, Gs^Fds, Gll^Fp, Gs^Fms, Gg, Gg, Gg, Gll^Fp, Gll^Fp, Gg, Gg, Gg, Gg, Gll^Fp, Gg, Gg, Gll^Fp, Gll^Fp, Gg, Gg, Gg, Gg, Gg, Gg, Gg, Rr, Rr, Cydy, Rr, Rr, Wwt, Cydy, Cydy, Rr, Rr, Rr, Rr^Rhx, Rr, Rr^Rhx, Rr, Rr, Rr^Rhx, Rr, Rr, Rr, Wwb, Rr, Rr, Rr, Rr^Rhx, Rr, Rr, Rr^Rhx, Rr^Rhx, Rr^Rhx, Rr, Rr, Kydy, Rr, Rr, Wwb, Wwb, Xos, Xos
Gg, Gg, Gg, Gll^Fp, Gll^Fp, Gs^Fds, Gll^Fp, Gg, Gll^Fp, Gs^Fms, Gll^Fp, Gs^Fds, Gll^Fp, Gg, Gll^Fp, Gll^Fp, Gll^Fp, Gll^Fp, Gs^Fds, Gg, Gll^Fp, Gll^Fp, Gll^Fp, Gll^Fp, Gs^Fds, Gg, Gg, Gs^Fms, Gg, Gg, Ce, Ce, Gg, Gs^Vc, Rb^Eff, Rr, Gg, Ds, Ds, Wwt, Cydy, Cydy, Rr, Rr^Rhx, Rr^Rhx, Rr^Rhx, Rr^Rhx, Rr^Rhx, Rr^Vhc, Rr, Rr^Rhx, Rr^Rhx, Rr^Rhx, Rr, Rr^Rhx, Rr^Rhx, Rr^Rhx, Rr, Rr, Rr^Rhx, Rr^Vhc, Rr^Rhx, Rr^Rhx, Rr^Rhx, Rr^Vhc, Rr, Wwb, Wwb, Wwb, Wwb, Xos, Xos
Gg, Gg, Gs^Fms, Gg, Gg, Gg, Gll^Fp, Gg, Gs^Fds, Gg, Gll^Fp, Gg, Gll^Fp, Gll^Fp, Gs^Fds, Gll^Fp, Gs^Fms, Gg, Gg, Gll^Fmw, Gll^Fp, Gs^Fms, Gs^Fms, Gs^Fms, Gg, Gs^Fds, Gll^Fp, Gs^Fds, Gg, Ce, Gg, Gg, Rb^Eff, Rb^Eff, Re^Gvs, Rb^Eff, Rb^Eff, Gs^Vc, Ds, Wwt, Wwt, Cydy, Cydy, Rr, Rr^Vhc, Rr^Rhx, Rr^Rhx, Rr^Rhx, Rr^Rhx, Rr, Rr^Rhx, Rr^Rhx, Rr^Rhx, Rr^Rhx, Rr^Rhx, Rr^Rhx, Rr, Rr, Rr, Rr, Rr, Rr^Rhx, Rr^Rhx, Rr^Rhx, Rr^Rhx, Rr, Wwb, Wwb, Xos, Xos, Xos, Xos
Gll^Fp, Gll^Fp, Gg, Gll^Fp, Gll^Fp, Gg, Gll^Fp, Gll^Fp, Gg, Gg, Gg, Gll^Fp, Gg, Gs^Fms, Gll^Fp, Gll^Fp, Gll^Fp, Gll^Fp, Gg, Gs^Fds, Gg, Gll^Fp, Gg, Gll^Fp, Gg, Gg, Gg, Gg, Gg, Ce, Rb^Eff, Rb^Eff, Re^Gvs, Re^Gvs, Re^Gvs, Re^Gvs, Re^Gvs, Rb^Eff, Rb^Eff, Ds, Wwt, Cydy, Cydy, Rr, Rr, Rr, Rr, Rr^Rhx, Rr, Rr, Rr, Rr, Rr, Rr, Rr, Rr, Cydy, Cydy, Wwb, Wwb, Wwb, Rr, Rr, Rr^Rhx, Rr, Rr, Wwb, Wwb, Xos, Xos, Xos, Xos
Gll^Fp, Gg, Gll^Fp, Gs^Fms, Gg, Gg, Gg, Gg, Gg, Gg, Gll^Fp, Gg, Gll^Fp, Gll^Fp, Gg^Fet, Gg, Gg, Gll^Fp, Gll^Fp, Gg, Gll^Fp, Gll^Fp, Gs^Fds, Gg, Gg, Gg, Ce, Ce, Rb^Eff, Rb^Eff, Re^Gvs, Re^Gvs, Re^Gvs, Re^Gvs, Re^Gvs, Re^Gvs, Re^Gvs, Re^Gvs, Re^Gvs, Rb^Eff, Rb^Eff, Wwt, Wwt, Rr, Cydy, Cydy, Cydy, Rr, Cydy, Cydy, Cydy, Cydy, Cydy, Cydy, Cydy, Cydy, Cydy, Cydy, Wwbf, Wwb, Wwb, Wwb, Wwb, Rr, Wwb, Wwb, Wwb, Wwb, Xos, Xos, Xos, Xos
Gll^Fp, Gll^Fp, Gg, Gg, Gll^Fp, Gs^Fds, Gll^Fmw, Gll^Fp, Gg, Gll^Fmw, Gll^Fp, Gll^Fp, Gg, Gg, Gll^Fp, Gg, Gg, Gg, Gg, Gg, Gll^Fp, Gg, Gg, Gg, Ce, Gg, Rb^Eff, Rb^Eff, Re^Gvs, Re^Gvs, Re^Gvs, Re^Gvs, Re^Gvs, Re^Gvs, Re^Gvs, Re^Gvs, Re^Gvs, Re^Gvs, Re^Gvs, Re^Gvs, Re^Gvs, Rb^Eff, Rb^Eff, Wwt, Wwt, Cydy, Wwt, Wwt^Bsb|, Wwt, Cydy, Wwt, Cydy, Wwt, Cydy, Wwt, Cydy, Wwt, Wwf, Xu, Xos, Xos, Wwb, Wwb, Wwb, Wwb, Wwb, Xos, Xos, Xos, Xos, Xos, Xos
Gg, Gll^Fp, Gg, Gs^Fds, Gg, Gll^Fp, Gg, Gll^Fp, Gll^Fp, Gll^Fp, Gg, Gll^Fp, Gg, Gll^Fp, Gll^Fp, Gg, Gg, Gs^Fms, Gll^Fp, Gg, Gg, Gg, Gg, Ce, Rb^Eff, Rb^Eff, Re^Gvs, Re^Gvs, Re^Gvs, Re^Gvs, Re^Gvs, Re^Gvs, Re^Gvs, Re^Gvs, Re^Gvs, Re^Gvs, Re^Gvs, Re^Gvs, Re^Gvs, Re^Gvs, Rb^Eff, Rb^Eff, Re^Wm, Rb^Eff, Rb^Eff, Wwt, Ds, Ww^Bsb|, Ds, Wwt, Ds, Wwt, Ds, Wwt, Ds, Wwt, Ds, Ds, Gg, Xu, Xu, Xos, Xos, Wwb, Xos, Xos, Xos, Xos, Xos, Xos, Xos, Xos
Gg, Gll^Fp, Gg, Gg, Gg, Gs^Fds, Gg, Gs^Fms, Gll^Fp, Gg, Gg, Gll^Fp, Gs^Fms, Gs^Fms, Gll^Fp, Gg, Gg, Gg, Gg, Gg, Ce, Ce, Rb^Eff, Rb^Eff, Rb^Eff, Re^Gvs, Re^Gvs, Re^Gvs, Re^Gvs, Re^Gvs, Re^Gvs, Re^Gvs, Re^Gvs, Re^Gvs, Re^Gvs, Re^Gvs, Re^Gvs, Re^Gvs, Rb^Eff, Rb^Eff, Re^Gvs, Re^Gvs, Re^Gvs, Re^Gvs, Re^Gvs, Rb^Eff, Rb^Eff, Ce, Gg, Ce, Gg, Ds, Cydy, Gg, Gg, Ds, Gg^Vc, Gg, Rb^Eff, Rb^Eff, Rb^Eff, Xu, Xu, Xos, Xu, Xos, Xu, Xu, Rr, Rr, Rr, Xos
Gs^Fms, Gll^Fp, Gg, Gg, Gll^Fp, Gs^Fms, Gg, Gll^Fp, Gg, Gg, Gg, Gg, Gg, Gs^Fds, Gg, Gg, Ce, Ce, Gg, Gg, Rb^Eff, Rb^Eff, Re^Gvs, Re^Wm, Re^Gvs, Rb^Eff, Rb^Eff, Re^Gvs, Re^Gvs, Re^Gvs, Re^Gvs, Re^Gvs, Re^Gvs, Re^Gvs, Re^Gvs, Re^Gvs, Rb^Eff, Rb^Eff, Re^Gvs, Re^Gvs, Re^Gvs, Re^Gvs, Re^Gvs, Re^Gvs, Re^Gvs, Re^Gvs, Re^Gvs, Rb^Eff, Rb^Eff, Gg^Vc, Gg, Cydy, Kydy, Cydy, Gg, Gg, Rb^Eff, Rb^Eff, Re^Gvs, Re^Wm, Re^Gvs, Rb^Eff, Rb^Eff, Xu, Gs^Fds, Gs^Fms, Gs^Fms, Rr, Cydy, Cydy, Cydy, Rr
Hh, Hh, Hh, Gg, Gg, Gg, Gs^Fms, Gs^Fds, Gg, Gll^Fp, Gg, Gg, Gg, Gll^Fp, Gg, Ce, Gg, Gg, Rb^Eff, Rb^Eff, Re^Gvs, Re^Gvs, Re^Gvs, Re^Gvs, Re^Gvs, Re^Gvs, Re^Gvs, Rb^Eff, Rb^Eff, Re^Gvs, Re^Gvs, Re^Gvs, Re^Gvs, Re^Gvs, Rb^Eff, Rb^Eff, Re^Gvs, Re^Gvs, Re^Gvs, Re^Gvs, Re^Gvs, Re^Gvs, Re^Gvs, Re^Gvs, Re^Gvs, Re^Gvs, Re^Gvs, Re^Gvs, Re^Gvs, Rb^Eff, Rb^Eff, Cydy, Cydy, Cydy, Rb^Eff, Rb^Eff, Re^Gvs, Re^Gvs, Re^Gvs, Re^Gvs, Re^Gvs, Re^Gvs, Re^Gvs, Rb^Eff, Rb^Eff, Gs^Vc, Gs, Rr, Cydy, Kydy, Cydy, Rr
Mm, Mm, Mm, Gll^Fp, Hh, Gg, Gs^Fds, Gg, Gll^Fp, Gll^Fp, Gll^Fp, Gll^Fmw, Gg, Gg, Gg, Gg, Rb^Eff, Rb^Eff, Re^Gvs, Re^Gvs, Re^Gvs, Re^Gvs, Re^Gvs, Re^Gvs, Re^Gvs, Re^Gvs, Re^Gvs, Re^Gvs, Re^Gvs, Rb^Eff, Rb^Eff, Re^Wm, Rb^Eff, Rb^Eff, Re^Gvs, Re^Gvs, Re^Gvs, Re^Gvs, Re^Gvs, Re^Gvs, Re^Gvs, Re^Gvs, Re^Gvs, Re^Gvs, Re^Gvs, Re^Gvs, Re^Gvs, Re^Gvs, Re^Gvs, Re^Gvs, Re^Gvs, Rb^Eff, Rb^Eff, Rb^Eff, Re^Gvs, Re^Gvs, Re^Gvs, Re^Gvs, Re^Gvs, Re^Gvs, Re^Gvs, Re^Gvs, Re^Gvs, Re^Gvs, Re^Gvs, Rb^Eff, Rb^Eff, Rr, Rr, Cydy, Rr, Rr
Mm, Mm^Xm, Mm^Xm, Mm, Mm, Hh, Gll^Fp, Gll^Fmw, Cydy, Cydy, Cydy, Gg, Gs^Vc, Gg, Rb^Eff, Rb^Eff, Re^Gvs, Re^Gvs, Re^Gvs, Re^Gvs, Re^Gvs, Re^Gvs, Re^Gvs, Re^Gvs, Re^Gvs, Re^Gvs, Re^Gvs, Re^Gvs, Re^Gvs, Re^Gvs, Rb^Eff, Rb^Eff, Rb^Eff, Re^Gvs, Re^Gvs, Re^Gvs, Re^Gvs, Re^Gvs, Re^Gvs, Re^Gvs, Re^Gvs, Re^Gvs, Re^Gvs, Re^Gvs, Re^Gvs, Re^Gvs, Re^Gvs, Re^Gvs, Re^Gvs, Re^Gvs, Rb^Eff, Rb^Eff, Re^Gvs, Re^Gvs, Re^Gvs, Re^Gvs, Re^Gvs, Re^Gvs, Re^Gvs, Re^Gvs, Re^Gvs, Re^Gvs, Re^Gvs, Re^Gvs, Rb^Eff, Rb^Eff, Gg, Gg, Gg, Rr, Gg, Gg
Mm, Mm, Mm, Mm^Xm, Mm, Mm, Mm, Hh, Cydy, Kydy, Cydy, Gg, Rb^Eff, Rb^Eff, Re^Gvs, Re^Gvs, Re^Gvs, Re^Gvs, Re^Gvs, Re^Gvs, Re^Gvs, Re^Gvs, Re^Gvs, Re^Gvs, Re^Gvs, Re^Gvs, Re^Gvs, Re^Gvs, Rb^Eff, Rb^Eff, Re^Gvs, Re^Gvs, Re^Gvs, Rb^Eff, Rb^Eff, Re^Gvs, Re^Gvs, Re^Gvs, Re^Gvs, Re^Gvs, Re^Gvs, Re^Gvs, Re^Gvs, Re^Gvs, Re^Gvs, Re^Gvs, Re^Gvs, Re^Gvs, Rb^Eff, Rb^Eff, Re^Gvs, Re^Gvs, Re^Gvs, Re^Gvs, Re^Gvs, Re^Gvs, Re^Gvs, Re^Gvs, Re^Gvs, Re^Gvs, Re^Gvs, Re^Gvs, Rb^Eff, Rb^Eff, Gg, Gg, Gs^Fms, Gs^Vc, Gg, Gg, Gg, Gg
Mm, Mm^Xm, Mm, Mm, Mm^Xm, Mm^Xm, Mm^Xm, Cydy, Ww, Cydy, Rr, Rb^Eff, Rb^Eff, Re^Gvs, Re^Gvs, Re^Gvs, Re^Gvs, Re^Gvs, Re^Gvs, Re^Gvs, Re^Gvs, Re^Gvs, Re^Gvs, Re^Gvs, Re^Gvs, Re^Gvs, Rb^Eff, Rb^Eff, Re^Gvs, Re^Gvs, Re^Gvs, Re^Gvs, Re^Gvs, Re^Gvs, Re^Gvs, Rb^Eff, Rb^Eff, Re^Gvs, Re^Gvs, Re^Gvs, Re^Gvs, Re^Gvs, Re^Gvs, Re^Gvs, Re^Gvs, Re^Gvs, Rb^Eff, Rb^Eff, Rb^Eff, Re^Gvs, Re^Gvs, Re^Gvs, Re^Gvs, Re^Gvs, Re^Gvs, Re^Gvs, Re^Gvs, Re^Gvs, Re^Gvs, Re^Gvs, Rb^Eff, Rb^Eff, Gg, Gg, Gg, Gs^Fms, Gs^Fms, Gs^Fms, Gg, Gs^Fms, Gs^Fds, Gg
Mm, Mm, Mm^Xm, Mm^Xm, Xu, Xu, Xu, Ww, Wwf, Wwf, Wwf, Rr, Rr, Rb^Eff, Rb^Eff, Re^Gvs, Re^Gvs, Re^Gvs, Re^Gvs, Re^Gvs, Re^Gvs, Re^Gvs, Re^Gvs, Re^Gvs, Rb^Eff, Rb^Eff, Re^Gvs, Re^Gvs, Re^Gvs, Re^Gvs, Re^Gvs, Re^Gvs, Re^Gvs, Re^Gvs, Re^Gvs, Re^Gvs, Re^Gvs, Rb^Eff, Rb^Eff, Re^Gvs, Re^Gvs, Re^Gvs, Re^Gvs, Re^Gvs, Rb^Eff, Rb^Eff, Re^Gvs, Re^Gvs, Re^Gvs, Rb^Eff, Rb^Eff, Re^Gvs, Re^Gvs, Re^Gvs, Re^Gvs, Re^Gvs, Re^Gvs, Re^Gvs, Rb^Eff, Rb^Eff, Gg, Gg, Gs^Fms, Gll^Fp, Gg, Gll^Fp, Gll^Fp, Gll^Fp, Gg, Gll^Fp, Gg, Gg
Mm, Mm^Xm, Xu, Xu, Xu, Xu, Xu, Xu, Xu, Wwf, Ww, Cydy, Mm^Xm, Hh, Hh, Rb^Eff, Rb^Eff, Re^Gvs, Re^Gvs, Re^Gvs, Re^Gvs, Re^Gvs, Rb^Eff, Rb^Eff, Re^Gvs, Re^Gvs, Re^Gvs, Re^Gvs, Re^Gvs, Re^Gvs, Re^Gvs, Re^Gvs, Re^Gvs, Re^Gvs, Re^Gvs, Re^Gvs, Re^Gvs, Re^Gvs, Re^Gvs, Rb^Eff, Rb^Eff, Re^Gvs, Rb^Eff, Rb^Eff, Re^Gvs, Re^Gvs, Re^Gvs, Re^Gvs, Re^Gvs, Re^Gvs, Re^Gvs, Rb^Eff, Rb^Eff, Re^Gvs, Re^Gvs, Re^Gvs, Rb^Eff, Rb^Eff, Gg, Gg, Gg, Gs^Fds, Gll^Fp, Gll^Fp, Gs^Fds, Gg, Gg, Gg, Gg, Gg, Gll^Fp, Gg
Mm^Xm, Mm^Xm, Xu, Xu, Qxu, Qxu, Ur, Xu, Xu, Xu, Xu, Ww, Mm^Xm, Mm, Mm, Hh, Gll^Fp, Rb^Eff, Rb^Eff, Re^Gvs, Rb^Eff, Rb^Eff, Re^Gvs, Re^Gvs, Re^Gvs, Re^Gvs, Re^Gvs, Re^Gvs, Re^Gvs, Re^Gvs, Re^Gvs, Re^Gvs, Re^Gvs, Re^Gvs, Re^Gvs, Re^Gvs, Re^Gvs, Re^Gvs, Re^Gvs, Re^Wm, Rb^Eff, Rb^Eff, Re^Gvs, Re^Gvs, Re^Gvs, Re^Gvs, Re^Gvs, Re^Gvs, Re^Gvs, Re^Gvs, Re^Gvs, Re^Gvs, Re^Wm, Rb^Eff, Rb^Eff, Rb^Eff, Gg, Gg, Gll, Gg, Gg, Gs^Fds, Gg, Gg, Gg, Gg, Gll^Fp, Gll, Gg, Gg, Gg, Gg
Xu, Xu, Xu, Uh, Uu, Qxu, Ur, Uh, Uh, Xu, Xu, Xu, Xu, Mm^Xm, Mm, Gs^Fms, Gg, Gg, Gg, Rb^Eff, Rb^Eff, Re^Gvs, Re^Gvs, Re^Gvs, Re^Gvs, Re^Gvs, Re^Gvs, Re^Gvs, Re^Gvs, Re^Gvs, Re^Gvs, Re^Gvs, Re^Gvs, Re^Gvs, Re^Gvs, Re^Gvs, Re^Gvs, Re^Gvs, Rb^Eff, Rb^Eff, Re^Gvs, Re^Gvs, Re^Gvs, Re^Gvs, Re^Gvs, Re^Gvs, Re^Gvs, Re^Gvs, Re^Gvs, Re^Gvs, Re^Gvs, Re^Gvs, Rb^Eff, Rb^Eff, Gg, Gg, Gll^Fp, Gg, Gll, Gs^Fms, Gll^Fp, Gg, Gg, Gs^Fds, Gll^Fp, Gg, Gs^Fms, Gg, Gs^Fms, Gll^Fp, Gll^Fp, Gg
Xu, Xu, Tb^Tf, Tb^Tf, Tb^Tf, Uu, Uu, Ur, Tb^Tf, Xu, Xu, Xu, Mm^Xm, Mm^Xm, Mm, Hh, Gg, Gs^Fms, Gll^Fp, Gg, Gg, Rb^Eff, Rb^Eff, Re^Gvs, Re^Gvs, Re^Gvs, Re^Gvs, Re^Gvs, Re^Gvs, Re^Gvs, Re^Gvs, Re^Gvs, Re^Gvs, Re^Gvs, Re^Gvs, Re^Gvs, Rb^Eff, Rb^Eff, Re^Gvs, Re^Gvs, Re^Gvs, Re^Gvs, Re^Gvs, Re^Gvs, Re^Gvs, Re^Gvs, Re^Gvs, Re^Gvs, Re^Gvs, Re^Gvs, Rb^Eff, Rb^Eff, Gg, Gg, Gll^Fp, Gs^Fms, Gll, Gll, Gll^Fp, Gs^Fms, Gg, Gg, Gg, Gg, Gll, Gg, Gll, Gg, Gg, Gll^Fp, Gg, Gg
Xu, Xu, Uh, Ur, Uh, Uh, Tb^Tf, Uu, Qxu, Xu, Mm^Xm, Mm^Xm, Mm, Mm, Mm, Hh, Gs^Fds, Gll^Fp, Gll, Gg, Gll^Fp, Gg, Gg, Rb^Eff, Rb^Eff, Re^Gvs, Re^Gvs, Re^Gvs, Re^Gvs, Re^Gvs, Re^Gvs, Re^Gvs, Re^Gvs, Re^Gvs, Rb^Eff, Rb^Eff, Rb^Eff, Re^Gvs, Re^Gvs, Re^Gvs, Re^Gvs, Re^Gvs, Re^Gvs, Re^Gvs, Re^Gvs, Re^Gvs, Re^Gvs, Re^Gvs, Rb^Eff, Rb^Eff, Gg, Gg, Gg, Gg, Gll, Gg, Gll, Gg, Gs^Fds, Gg, Gg, Gs^Fds, Gg, Gg, Gg, Gll^Fp, Gg, Gll, Gg, Gg, Gg, Gs^Fms
Uh, Uh, Ur, Ur, Uh, Uu, Urb, Urb, Qxu, Xu, Mm^Xm, Mm, Mm, Mm, Mm, Mm, Hh, Gg, Gll^Fp, Gll, Gs^Fms, Gll^Fp, Gg, Gg, Gll^Fp, Rb^Eff, Rb^Eff, Re^Gvs, Re^Gvs, Re^Gvs, Re^Gvs, Re^Gvs, Rb^Eff, Rb^Eff, Gg, Gg, Gg, Rb^Eff, Rb^Eff, Re^Gvs, Re^Gvs, Re^Gvs, Re^Gvs, Re^Gvs, Re^Gvs, Re^Gvs, Rb^Eff, Rb^Eff, Gll^Fp, Gs^Fds, Gg, Gg, Gs^Fds, Gg, Gll^Fp, Gs^Fds, Gg, Gs^Fms, Gg, Gll^Fp, Gg, Gg, Gll^Fp, Gs^Fds, Gll^Fp, Gg, Gg, Gs^Fms, Gll^Fp, Gg, Gll, Gs^Fds
Uu, Uu, Tb^Tf, Uu, Ur, Uu, Qxu, Qxu, Xu, Xu, Mm^Xm, Mm, Mm, Mm, Mm^Xm, Mm, Mm, Hh, Gll, Gg, Gll^Fp, Gg, Gg, Gs^Fms, Gg, Gg, Gg, Rb^Eff, Rb^Eff, Re^Gvs, Rb^Eff, Rb^Eff, Gg, Gg, Gll^Fp, Gll^Fmw, Gll^Fp, Gg, Gg, Rb^Eff, Rb^Eff, Re^Gvs, Re^Gvs, Re^Gvs, Rb^Eff, Rb^Eff, Gg, Gg, Gll^Fp, Gg, Gg, Gll, Gs^Fms, Gll, Gg, Gg, Gll^Fp, Gll^Fp, Gg, Gg, Gs^Fms, Gg, Gg, Gs^Fms, Gg^Fet, Gg, Gs^Fms, Gll^Fp, Gs^Fms, Gg, Gg, Gg
Uu, Ur, Tb^Tf, Uu, Xu, Xu, Xu, Xu, Mm^Xm, Mm^Xm, Mm, Mm, Mm^Xm, Mm^Xm, Mm, Mm, Mm, Hh, Hh, Gg, Gs^Fms, Gs^Fms, Gg, Gg, Gg, Gs^Fms, Gs^Fms, Gs^Fms, Gg, Rb^Eff, Gs^Fms, Gll^Fp, Gll^Fp, Gg, Gg, Gs^Fds, Gg, Gg, Gg, Gll^Fp, Gg, Rb^Eff, Rb^Eff, Rb^Eff, Gs^Fds, Gs^Fms, Gg, Gll^Fp, Gg, Gs^Fds, Gg, Gll, Gll^Fp, Gs^Fms, Gg, Gll^Fp, Gs^Fms, Gg, Gg, Gll, Gll^Fp, Gs^Fms, Gll, Gll^Fp, Gg, Gg, Gg, Gs^Fms, Gg, Gg, Gg, Gg
Ur, Ur, Uu, Uu, Xu, Xu, Mm, Mm^Xm, Mm, Mm, Mm, Mm, Mm, Mm, Mm, Mm, Mm, Mm, Hh, Gll, Gg, Gs^Fms, Gg, Gll^Fp, Gg, Gg, Gg, Gll^Fp, Gg, Gg, Gg, Gs^Fds, Gg, Gg, Gg, Gll^Fp, Gg, Gg, Gg, Gg, Gg, Gg, Gll, Gll^Fp, Gg, Gg, Gg, Gll^Fp, Gg, Gg, Gg, Gll, Gg, Gg, Gg, Gg, Gs^Fms, Gll, Gg, Gg, Gs^Fms, Gg, Gs^Fds, Gg, Gll^Fp, Gg, Gg, Gg, Gg, Gs^Fms, Gg, Gg
