Dd, Dd, Dd^Esd, Dd, Dd, Dd^Ftd, Dd, Dd^Edpp, Dd, Dd, Dd, Dd, Dd, Dd, Dd, Hd, Dd, Dd, Dd, Dd^Ftd, Dd, Dd, Dd, Dd, Dd, Dd, Dd^Ftd, Dd, Dd, Dd, Dd, Dd, Dd, Dd, Dd^Ftd, Hd, Dd^Esd, Dd, Dd, Dd^Edpp, Dd, Dd^Esd, Dd, Mdd, Dd, Hd, Dd^Edp, Dd, Dd, Dd, Dd, Dd, Dd, Dd, Dd, Dd, Dd, Dd^Ftd, Hd, Dd, Dd, Dd, Dd^Edpp, Dd^Esd, Dd, Dd, Dd, Dd, Dd, Dd, Dd, Dd, Dd, Dd, Dd, Dd, Dd, Dd, Dd, Dd, Dd, Dd
Dd^Esd, Rd, Rd, Dd, Ce, Dd^Dc, Dd, Dd, Ce, Dd^Ftd, Dd, Dd, Dd, Dd, Dd, Dd, Dd, Dd, Dd, Dd, Dd, Dd, Dd, Dd, Dd, Dd, Dd, Dd^Esd, Dd, Dd^Dr, Dd, Dd^Edp, Dd^Ftd, Dd, Dd^Ftd, Dd, Dd, Dd, Dd, Dd, Dd, Dd, Dd^Dc, Dd, Dd^Dc, Dd, Dd^Ftd, Dd, Dd, Dd, Dd, Dd, Dd, Dd, Rd, Dd, Dd, Dd, Dd, Dd, Dd^Esd, Dd, Rd, Dd, Dd, Dd, Dd, Dd, Dd, Dd, Rd, Rd, Dd, Dd, Dd^Dc, Dd, Hd, Dd, Dd, Dd, Dd, Dd^Ftd
Dd, Dd^Edpp, Rd, Ce, Ke, Ce, Ce, Ce, Ke, Ce, Dd, Dd, Dd, Dd, Dd, Dd, Dd, Dd, Dd, Dd^Esd, Dd, Dd, Dd, Dd, Dd^Ftd, Rd, Dd^Ftd, Dd, Dd^Edpp, Dd, Hd, Dd, Dd, Rd, Dd, Dd, Dd, Dd^Esd, Dd, Dd, Dd, Dd, Dd, Dd, Dd^Edp, Dd, Dd, Dd, Dd, Dd, Dd, Dd, Dd, Dd^Ftd, Dd, Dd^Edpp, Dd, Dd, Dd, Dd, Dd, Hd, Dd, Dd, Dd, Dd, Dd, Dd, Dd, Dd, Dd, Dd^Ftd, Dd, Dd, Ce, Dd^Ftd, Dd, Dd, Dd^Esd, Dd^Dc, Dd, Dd
Dd, Dd, Hd, Ce, Ce, Ce, Dd, Ce, Ce, Ce, Dd, Hd, Dd, Dd, Dd, Dd, Dd, Hd, Dd, Dd, Hd, Dd, Dd, Dd, Dd, Dd, Dd, Dd, Dd, Dd, Dd^Edpp, Hd, Dd, Dd^Ftd, Ce, Dd, Dd^Ftd, Dd, Dd, Dd, Dd, Dd^Esd, Dd, Dd, Rd, Dd, Dd, Dd, Dd, Dd, Dd, Dd, Dd, Dd, Dd, Dd, Dd, Dd, Dd, Dd, Dd, Dd, Dd, Dd, Dd^Dc, Dd, Dd, Dd, Dd, Dd, Dd, Dd, Dd, Ce, 1 Ke, Ce, Dd, Hd, Dd, Dd, Dd^Edp, Dd
Dd, Dd, Dd, Ce, Dd, Dd, Dd, Dd, Dd^Ftd, Dd, Hd, Dd, Dd, Dd, Dd, Dd, Dd, Dd, Ce, Dd, Dd, Dd, Dd, Dd, Dd, Dd, Dd, Dd, Dd, Dd, Dd, Dd, Ce, Ce, Ce, Ce, Dd, Dd, Dd, Dd, Mdd, Dd, Hd, Dd, Dd, Dd, Dd^Edpp, Dd, Dd, Dd, Dd, Dd, Dd, Dd, Dd, Dd, Dd, Dd, Dd, Dd, Dd, Dd, Dd, Dd, Rd, Dd, Dd, Dd, Dd, Dd, Dd, Dd, Dd, Ce, Ce, Ce, Mdd, Dd, Dd, Dd, Dd^Edp, Dd^Esd
Dd, Dd, Ce, Ce, Ce, Dd, Dd, Dd, Dd, Mdd, Dd, Dd, Dd, Dd, Dd, Dd, Dd, Ce, Ke, Ce, Dd, Dd, Dd, Dd, Dd, Dd, Dd, Dd^Dc, Dd, Dd, Dd^Edpp, Ce, Ce, Ke, Ce, Ce, Dd^Ftd, Dd, Dd, Dd, Dd, Dd, Dd, Mdd, Dd^Ftd, Dd, Dd, Dd, Dd^Ftd, Dd^Ftd, Dd, Dd, Mdd, Dd, Hd, Dd, Dd, Dd, Dd, Dd, Dd^Esd, Dd^Ftd, Dd, Dd^Do, Dd, Mdd, Dd, Dd, Dd, Dd^Ftd, Dd, Dd, Dd, Dd, Dd, Dd, Dd, Mdd, Rd, Dd, Dd^Dr, Dd
Dd, Dd, Ce, Ke, Ce, Dd, Dd, Dd, Dd^Ftd, Dd, Dd, Dd, Mdd, Dd, Dd, Dd^Ftd, Dd, Ce, Ce, Ce, Dd, Dd, Dd, Dd, Dd, Dd, Dd, Dd, Dd, Dd^Esd, Hd, Ce, Ce, Ce, Dd, Dd, Dd, Dd, Dd, Dd, Dd, Dd, Dd, Dd, Dd, Dd, Dd, Dd, Dd, Dd, Dd, Dd, Dd, Dd, Dd, Dd, Dd^Dc, Dd, Dd, Mdd, Dd, Dd, Rd, Dd, Dd, Dd, Dd, Dd, Dd, Dd, Dd, Dd, Dd, Dd, Dd^Dc, Dd^Ftd, Dd, Dd, Dd, Dd, Dd^Esd, Dd
Dd^Edp, Dd, Dd, Ce, Dd, Dd, Dd^Edp, Dd, Dd, Dd, Dd, Rd, Dd, Dd^Esd, Dd^Edpp, Dd, Dd, Dd, Dd, Dd, Dd, Dd^Ftd, Dd, Dd, Dd, Dd, Dd, Dd, Dd, Dd, Dd, Dd, Dd, Dd, Dd, Dd, Dd, Dd, Dd, Dd, Dd, Dd^Do, Dd, Dd, Dd, Dd, Rd, Dd, Dd, Dd^Do, Dd, Dd, Dd, Dd, Mdd, Dd, Dd, Dd, Dd, Dd, Dd, Hd, Dd, Dd, Dd, Dd^Esd, Dd, Dd, Dd, Dd, Dd, Dd, Dd^Ftd, Dd, Dd, Dd, Rd, Dd, Dd, Dd^Ftd, Dd^Edpp, Dd
Dd, Dd, Dd, Dd, Dd, Dd, Dd, Dd^Ftd, Dd^Ftd, Dd^Edp, Dd, Dd, Dd^Do, Dd, Dd, Dd, Dd, Dd, Dd, Dd, Dd, Dd, Dd^Edp, Dd, Dd, Dd^Edpp, Dd, Dd, Dd, Dd, Dd, Dd, Dd, Dd, Dd, Dd, Dd, Dd, Dd, Dd, Dd^Ftd, Dd, Dd, Dd, Dd^Ftd, Dd, Dd^Edpp, Dd, Dd, Dd, Dd, Dd, Dd^Ftd, Dd, Dd, Dd, Dd, Dd, Dd, Dd, Dd, Dd, Dd, Dd, Dd, Dd^Ftd, Dd^Dr, Dd, Dd, Dd, Dd, Dd, Dd, Dd, Dd, Dd, Dd, Dd^Edpp, Dd^Ftd, Dd, Dd, Dd
Dd, Rd, Hd, Dd, Dd^Ftd, Hd, Dd, Dd, Dd^Edp, Dd, Dd^Edp, Dd, Dd, Dd^Esd, Dd^Ftd, Dd^Ftd, Dd, Rd, Dd, Dd, Dd, Dd, Dd, Dd, Dd^Esd, Dd, Dd, Dd, Dd, Dd, Dd, Dd, Dd^Ftd, Dd^Ftd, Dd, Dd, Dd, Dd^Edp, Dd^Ftd, Dd, Dd, Dd, Dd, Dd, Dd, Dd, Dd, Dd, Dd, Dd, Dd, Dd, Dd, Dd^Esd, Dd, Dd, Dd, Dd, Dd, Dd, Dd, Rd, Dd, Dd, Dd, Dd, Dd, Dd^Dc, Dd^Edp, Dd, Dd, Dd, Dd, Dd, Dd^Esd, Dd, Dd, Dd, Dd, Dd, Dd, Dd
Dd, Dd, Dd, Dd^Ftd, Dd, Dd, Rd, Dd, Dd, Dd, Dd, Dd^Dr, Dd, Dd, Dd, Dd, Dd, Dd, Dd^Esd, Dd, Dd, Dd, Mdd, Dd, Dd, Dd, Dd, Dd, Dd, Dd, Dd, Dd, Dd^Edp, Dd^Esd, Dd^Edpp, Dd, Dd, Dd, Dd, Dd, Dd, Dd, Dd, Dd, Dd, Dd^Edpp, Dd, Dd, Dd, Dd, Dd, Dd^Ftd, Dd, Dd, Dd, Dd, Mdd, Dd, Dd^Ftd, Dd, Hd, Dd, Dd, Dd, Dd, Dd, Dd, Dd, Dd, Dd^Dr, Dd, Dd, Hd, Dd^Ftd, Dd, Dd, Dd^Edp, Dd, Dd, Hd, Dd, Dd
Dd, Dd^Ftd, Dd, Dd, Dd, Rd, Dd, Dd^Ftd, Dd, Dd, Dd, Dd, Rd, Dd, Dd, Dd^Edpp, Dd, Rd, Hd, Dd, Dd, Dd, Dd, Dd, Dd, Hd, Dd, Dd, Dd, Dd, Dd, Dd^Ftd, Rd, Dd, Dd^Esd, Dd^Edpp, Dd, Dd, Dd, Dd^Ftd, Dd, Dd, Dd, Dd, Dd^Dc, Dd, Dd, Dd, Hd, Dd, Dd, Hd, Hd, Dd, Dd, Dd, Dd^Edp, Dd, Dd, Dd, Dd, Dd, Dd, Dd, Dd^Dc, Dd, Dd^Edpp, Dd, Dd, Dd, Dd, Dd^Ftd, Dd, Dd, Dd, Dd, Dd, Dd^Dr, Dd, Dd, Dd^Edpp, Hd
Dd, Dd^Edp, Dd, Dd, Dd^Ftd, Dd, Dd^Ftd, Dd, Dd, Dd, Dd^Ftd, Dd, Dd, Dd, Dd, Dd, Rd, Dd, Dd, Dd, Dd, Dd, Dd, Dd^Dc, Dd, Dd, Mdd, Hd, Hd, Dd, Rd, Dd^Ftd, Dd, Dd, Dd^Ftd, Dd, Dd, Dd, Dd, Dd, Dd, Dd, Dd^Edpp, Dd, Dd, Dd^Ftd, Dd, Dd, Dd^Ftd, Hd, Mdd, Mdd, Mdd, Dd, Hd, Dd, Dd, Dd^Edpp, Dd, Dd, Dd, Dd, Dd^Ftd, Dd, Dd, Dd, Rd, Dd, Dd, Dd, Dd, Dd, Dd, Dd^Esd, Dd, Dd^Ftd, Hd, Mdd, Dd, Dd, Dd, Dd^Edp
Dd, Hd, Dd, Dd^Ftd, Dd, Dd, Rd, Dd, Dd, Dd, Dd^Ftd, Dd, Dd, Dd, Dd, Rd, Dd, Dd^Ftd, Dd, Dd, Dd, Dd, Dd, Dd, Dd, Dd, Mdd, Mdd, Hd, Dd^Ftd, Dd, Rd, Dd, Dd, Dd, Dd^Esd, Dd, Dd, Dd, Dd, Rd, Dd, Dd, Hd, Dd, Dd, Dd, Dd^Dr, Dd, Hd, Cd, Mdd, Mdd, Mdd, Hd, Dd^Ftd, Dd, Hd, Dd, Dd, Dd, Dd, Dd, Dd, Dd, Dd, Dd, Dd, Dd, Dd, Dd, Dd, Dd, Dd^Ftd, Dd^Ftd, Rd, Hd, Dd, Dd, Dd, Dd, Dd
Hd, Dd, Dd, Dd, Dd, Dd, Dd, Dd, Dd, Dd, Dd, Dd, Dd, Dd, Dd, Dd, Dd, Dd, Dd, Dd, Dd, Dd^Edp, Dd, Dd, Dd, Dd, Hd, Mdd, Mdd, Mdd, Hd, Dd, Dd, Dd, Hd, Dd, Dd, Dd, Mdd, Dd, Hd, Hd, Mdd, Dd^Ftd, Hd, Hd, Dd, Hd, Hd, Cd, Kd, Cd, Cd, Cd, Cd, Dd, Dd, Dd^Ftd, Dd, Dd, Dd, Dd^Dr, Dd, Dd, Dd, Dd, Dd, Dd, Dd^Ftd, Dd, Dd, Dd, Dd, Dd, Dd^Edp, Dd, Dd, Mdd, Dd^Ftd, Dd, Dd^Edp, Dd^Edp
Dd, Dd, Dd, Dd, Dd, Dd, Dd, Dd, Dd, Dd, Rd, Dd, Dd, Dd^Ftd, Dd, Dd^Edpp, Dd, Dd, Dd, Dd, Mdd, Dd, Dd^Edp, Dd, Dd, Hd, Mdd, Mdd, Mdd, Hd, Mdd, Mdd, Mdd, Mdd, Mdd, Hd, Mdd, Mdd, Mdd, Mdd, Mdd, Mdd, Mdd, Mdd, Mdd, Hd, Mdd, Mdd, Mdd, Cd, Cd, Cd, Cd, Kd, Cd, Dd, Hd, Dd, Dd^Esd, Dd, Dd, Dd^Ftd, Dd^Ftd, Dd, Dd, Dd, Dd, Dd, Dd^Esd, Dd, Dd^Edp, Dd, Dd, Rd, Dd, Dd, Dd^Ftd, Dd, Dd, Dd, Dd, Dd
Dd, Dd, Dd^Edp, Dd, Dd, Dd, Dd, Dd, Dd, Dd, Dd, Dd^Ftd, Dd^Ftd, Dd, Dd, Dd, Dd, Dd, Dd, Dd, Dd, Dd, Hd, Hd, Mdd, Hd, Mdd, Mdd, Mdd, Mdd, Mdd, Mdd, Mdd, Mdd, Mdd^Xm, Mdd, Mdd, Mdd, Mdd^Xm, Mdd, Mdd, Mdd, Mdd, Mdd, Mdd, Mdd, Mdd, Mdd, Mdd^Xm, Mdd^Xm, Mdd^Xm, Hd, Hd, Cd, Mdd, Mdd, Mdd, Hd, Dd, Dd, Dd, Dd, Dd, Dd^Dc, Dd, Dd, Dd, Dd, Dd, Dd, Dd, Dd, Hd, Dd^Ftd, Dd, Dd, Dd, Dd, Dd, Dd^Esd, Dd^Edpp, Dd
Dd, Dd, Dd, Dd, Dd, Dd, Dd, Mdd, Dd, Dd, Dd, Dd, Dd, Dd, Dd, Dd, Dd, Dd, Dd^Ftd, Hd, Mdd, Dd, Mdd, Mdd, Mdd, Mdd, Mdd^Xm, Mdd, Mdd, Mdd, Mdd^Xm, Mdd^Xm, Mdd^Xm, Mdd^Xm, Mdd^Xm, Mdd^Xm, Mdd^Xm, Mdd^Xm, Mdd^Xm, Mdd^Xm, Mdd^Xm, Mdd, Mdd, Mdd, Mdd^Xm, Mdd^Xm, Mdd^Xm, Mdd^Xm, Mdd^Xm, Mdd^Xm, Hd, Mdd, Mdd, Hd, Mdd, Mdd, Mdd, Mdd, Dd, Dd, Dd, Dd, Dd^Edp, Dd, Dd, Dd^Ftd, Dd, Dd^Edpp, Hd, Dd^Esd, Dd, Dd^Edp, Dd, Dd, Dd, Dd, Dd, Rd, Dd, Dd, Dd, Dd
Dd^Esd, Dd, Dd, Dd, Dd, Dd, Dd^Dr, Rd, Dd, Dd, Dd, Dd^Ftd, Dd, Dd^Edp, Dd, Dd, Dd, Rd, Dd, Hd, Mdd, Hd, Hd, Mdd, Mdd^Xm, Mdd^Xm, Xu, Mdd^Xm, Mdd^Xm, Mdd^Xm, Xu, Xu, Xoa, Xoa, Xoa, Mdd^Xm, Mdd^Xm, Mdd^Xm, Mdd^Xm, Mdd^Xm, Mdd^Xm, Mdd^Xm, Mdd^Xm, Mdd^Xm, Mdd^Xm, Mdd^Xm, Mdd^Xm, Mdd^Xm, Xoa, Xoa, Rb, Mdd, Xoa, Mdd^Xm, Mdd^Xm, Mdd^Xm, Mdd^Xm, Mdd, Hd, Dd, Dd^Edpp, Dd, Dd^Esd, Dd, Dd, Dd, Dd, Dd, Dd^Ftd, Dd, Dd, Dd, Dd, Dd, Dd, Dd, Dd, Dd, Dd, Dd, Dd, Dd
Dd^Edpp, Dd^Ftd, Dd, Dd, Dd, Dd, Dd, Dd, Dd, Dd, Dd, Mdd, Dd, Dd, Dd, Dd, Mdd, Mdd, Mdd, Rd, Hd, Mdd, Hd, Mdd^Xm, Xu, Xu, Uh, Xu, Xu, Xu, Tb^Tf, Uu, Rb, Rb, Rb, Xoa, Mdd^Xm, Mdd^Xm, Mdd^Xm, Mdd^Xm, Mdd^Xm, Mdd^Xm, Mdd^Xm, Mdd^Xm, Mdd^Xm, Mdd^Xm, Mdd^Xm, Mdd^Xm, Xoa, Rb, Rb, Rb, Xoa, Mdd^Xm, Mdd^Xm, Mdd^Xm, Mdd^Xm, Mdd, Mdd, Dd^Edp, Dd, Dd, Dd, Dd, Dd, Dd, Dd, Dd, Dd, Dd, Dd, Dd^Ftd, Rd, Dd, Dd, Dd, Dd, Dd, Dd, Dd, Dd, Dd
Hd, Dd^Edp, Dd, Dd^Ftd, Mdd, Dd, Dd, Dd, Dd, Rd, Dd^Ftd, Dd, Dd, Dd, Hd, Hd, Mdd, Mdd, Mdd^Xm, Mdd^Xm, Mdd^Xm, Hd, Tb^Tf, Uh, Uu, Tb^Tf, Cud, Uh, Uu, Tb^Tf, Uh, Uh, Rb, Rb, Rb, Xoa, Mdd^Xm, Mdd^Xm, Mdd^Xm, Mdd^Xm, Mdd^Xm, Mdd^Xm, Mdd^Xm, Mdd^Xm, Mdd^Xm, Mdd^Xm, Mdd^Xm, Mdd^Xm, Xoa, Rb, Rb, Rb, Xoa, Xos, Xos, Mdd^Xm, Mdd^Xm, Mdd^Xm, Mdd, Dd, Dd, Dd^Edp, Dd, Dd^Edp, Dd, Dd, Dd, Dd, Dd, Dd, Dd, Dd, Dd, Dd, Dd, Dd, Dd, Dd, Dd, Dd, Dd, Dd
Dd, Dd, Dd, Rd, Dd, Dd, Dd, Dd, Dd, Dd, Dd, Dd, Dd, Dd^Ftd, Hd, Mdd, Mdd, Mdd, Mdd^Xm, Xu, Xu, Tb^Tf, Ur, Uh, Uu, Cud, Kud, Cud, Ur, Ur, Xu, Uu, Xoa, Rb, Xoa, Xoa, Xu, Mdd^Xm, Mdd^Xm, Mdd^Xm, Mdd^Xm, Mdd^Xm, Mdd^Xm, Mdd^Xm, Mdd^Xm, Mdd^Xm, Xu, Xu, Xos, Xoa, Xoa, Xoa, Urb^Pr\, Urb, Urb, Xos, Mdd^Xm, Mdd^Xm, Hd, Cd, Cd, Dd, Dd, Dd, Dd, Dd, Dd, Dd, Dd, Dd, Dd, Dd^Edpp, Dd, Dd^Edp, Dd, Dd^Ftd, Dd, Dd, Dd, Dd, Dd, Dd
Dd, Dd, Dd^Edp, Dd, Dd^Ftd, Dd, Dd, Dd, Rd, Dd^Ftd, Dd, Dd^Edpp, Dd, Dd^Ftd, Dd, Mdd, Mdd, Mdd^Xm, Mdd^Xm, Xu, Xu, Uu, Ur, Uh, Ur, Cud, Uh, Uh, Tb^Tf, Xu, Xu, Xu, Xu, Xoa, Xu, Xu, Xu, Xu, Xu, Xu, Xu, Mdd^Xm, Xu, Mdd^Xm, Xu, Xu, Xos, Xos, Urb, Xos, Urb^Pr\, Urb, Urb, Xos, Xos, Xos, Urb, Mdd, Hd, Hd, Mdd, Dd, Hd, Hd, Dd^Edp, Dd, Dd, Dd, Dd, Dd^Dc, Dd, Dd, Dd, Dd, Dd, Mdd, Dd^Ftd, Dd, Dd^Ftd, Dd, Dd, Dd^Ftd
Dd, Dd, Dd, Dd, Dd, Dd, Dd, Dd, Dd, Dd, Dd, Dd, Dd, Dd^Ftd, Dd, Hd, Mdd, Mdd, Mdd^Xm, Mdd^Xm, Xu, Uu^Vu, Tb^Tf, Uu, Uu, Uu^Vu, Xu, Tb^Tf, Xu, Xu, Xu, Xu, Xu, Xu, Xu, Xu, Xu, Xu, Qxua, Qxua, Qxua, Xu, Qxua, Xu, Qxua, Xu, Xu, Xos, Xos, Urb, Xos, Xos, Xos, Urb, Urb, Urb, Urb, Urb, Mdd^Xm, Mdd, Mdd, Mdd, Mdd, Hd, Mdd, Dd, Dd^Esd, Dd, Dd, Dd, Dd, Dd, Dd, Dd, Dd, Dd, Dd, Dd, Dd, Dd, Dd, Dd
Dd, Dd, Dd, Dd, Dd, Dd, Dd, Dd, Dd, Dd^Edp, Dd^Edp, Dd, Dd, Dd^Ftd, Hd, Mdd, Mdd^Xm, Mdd^Xm, Mdd^Xm, Xu, Xu, Xu, Xu, Tb^Tf, Xu, Xu, Xu, Xu, Xoa, Xu, Xu, Xu, Xu, Xu, Qxua, Qxua, Qxua, Qxua, Qxua, Qxua, Qxua, Qxua, Qxua, Qxua, Qxua, Qxua, Qxua, Xu, Xu, Xos, Urb, Xos, Urb^Pr\, Urb, Urb, Urb, Urb^Pr/, Xos, Xos, Mdd^Xm, Mdd, Mdd, Mdd, Mdd, Mdd, Mdd, Hd, Hd, Dd, Dd, Dd, Dd, Dd, Dd^Edp, Dd, Dd, Dd, Dd, Dd, Dd, Hd, Dd
Dd, Hd, Dd, Dd^Do, Dd^Edp, Dd, Dd, Dd, Hd, Dd, Dd, Dd, Dd, Dd, Mdd, Mdd, Mdd^Xm, Mdd^Xm, Mdd, Mdd^Xm, Mdd^Xm, Xu, Xu, Xu, Xu, Xu, Xoa, Xoa, Rb, Xoa, Xoa, Xu, Xu, Qxua, Qxua, Qxua, Qxua, Qxua, Qxua, Qxua, Tb^Tf, Qxua, Uu, Qxua, Qxua, Qxua, Qxua, Xu, Xu, Xos, Xos, Urb, Xos, Xos, Urb^Pr\, Xos, Urb, Urb, Xos, Mdd^Xm, Mdd^Xm, Mdd, Mdd, Mdd, Mdd, Mdd, Hd, Dd^Edp, Dd, Dd, Dd, Dd, Dd, Dd, Dd^Edpp, Dd, Dd^Edpp, Dd, Dd, Dd, Dd, Dd
Dd, Rd, Dd, Dd, Rd, Dd^Edpp, Dd, Dd, Dd, Dd, Dd, Dd, Dd, Dd^Do, Hd, Mdd^Xm, Mdd^Xm, Mdd, Hd, Mdd, Mdd, Mdd^Xm, Mdd^Xm, Xu, Xu, Xu, Xoa, Rb, Rb, Rb, Xoa, Xu, Xu, Qxua, Qxua, Qxua, Uh, Uh, Urb, Ur, Rb^Sr, Tb^Tf, Uu, Uh, Uh, Qxua, Qxua, Qxua, Xu, Xu, Xu, Xos, Xos, Urb, Urb, Xos, Xos, Xos, Xu, Mdd^Xm, Mdd^Xm, Mdd, Mdd, Mdd, Mdd, Mdd, Mdd, Mdd, Dd, Dd, Dd^Esd, Dd, Dd, Dd, Dd, Dd, Dd, Dd, Dd, Dd, Dd, Dd^Ftd
Dd, Dd, Dd, Dd, Dd^Esd, Dd, Dd, Dd, Dd, Dd, Dd, Dd, Dd, Dd, Dd, Hd, Mdd, Mdd, Mdd, Hd, Cd, Mdd, Mdd, Mdd^Xm, Mdd^Xm, Mdd^Xm, Hd, Rb, Rb, Rb, Xoa, Xu, Xu, Qxua, Qxua, Qxua, Tb^Tf, Uh, Urb, Rb^Sr, Rb^Sc, Rb^Sr, Ur, Uh, Qxua, Qxua, Qxua, Qxua, Xos, Xos, Xos, Xu, Xu, Xos, Xu, Xos, Xu, Xu, Xoa, Mdd^Xm, Mdd^Xm, Mdd^Xm, Mdd, Mdd, Mdd, Mdd, Mdd, Mdd, Hd, Dd^Ftd, Dd^Ftd, Dd, Hd, Dd, Dd, Dd, Dd^Ftd, Dd, Hd, Dd, Dd, Dd
Dd, Dd, Dd^Ftd, Dd^Edp, Dd, Dd, Dd, Dd, Dd, Dd, Dd^Ftd, Dd, Dd, Dd, Dd, Dd^Ftd, Hd, Hd, Dd, Cd, Kd, Cd, Hd, Mdd^Xm, Mdd, Mdd^Xm, Mdd, Mdd, Hd, Xoa, Xu, Xu, Xu, Qxua, Qxua, Qxua, Tb^Tf, Urb, Uu, Rb^Sr, Rb^Sr, Rb^Sr, Uu, Ur, Qxua, Qxua, Qxua, Qxua, Xos, Urb, Urb, Xos, Xos, Xu, Xu, Xu, Xoa, Xoa, Rb, Xoa, Xoa, Mdd^Xm, Mdd, Mdd, Mdd, Mdd, Mdd, Hd, Dd, Dd, Dd, Dd, Dd, Dd^Ftd, Dd, Dd, Dd, Dd, Dd, Dd, Dd, Dd
Dd, Mdd, Dd, Dd, Dd, Dd^Ftd, Dd, Dd, Dd, Dd, Dd^Ftd, Dd^Edp, Dd^Esd, Dd, Dd^Esd, Dd, Cd, Dd, Dd, Cd, Cd, Cd, Cd, Hd, Hd, Mdd, Mdd, Hd, Mdd^Xm, Mdd^Xm, Mdd^Xm, Xu, Qxua, Qxua, Qxua, Qxua, Uu, Uh, Uh, Ur, Uh, Uu, Uh, Qxua, Qxua, Qxua, Xos, Xos, Xos, Urb, Xos, Xos, Urb, Xos, Xos, Xu, Xoa, Rb, Rb, Rb, Xoa, Mdd^Xm, Mdd, Mdd, Mdd, Mdd, Hd, Dd, Dd, Dd, Dd, Dd, Dd, Dd, Rd, Rd, Dd, Dd, Dd, Dd, Hd, Dd
Dd, Dd, Dd, Dd, Dd, Dd^Esd, Dd, Dd, Dd, Dd, Dd, Dd, Dd, Dd, Dd, Dd, Hd, Dd, Dd, Dd, Cd, Kd, Cd, Mdd^Xm, Hd, Hd, Mdd, Hd, Mdd, Mdd^Xm, Mdd^Xm, Xu, Xu, Qxua, Qxua, Qxua, Uu, Uh, Urb, Ur, Uh, Uh, Qxua, Qxua, Qxua, Qxua, Xos, Urb, Urb, Urb^Pr\, Xos, Urb, Urb, Urb, Xos, Xu, Xoa, Rb, Rb, Rb, Xoa, Mdd^Xm, Mdd^Xm, Mdd, Mdd, Mdd, Hd, Dd^Edp, Dd, Dd, Dd, Dd^Ftd, Dd, Dd, Dd^Ftd, Dd, Dd, Dd^Dr, Dd^Ftd, Dd^Esd, Dd, Dd
Dd, Dd, Dd, Dd, Dd, Mdd, Dd, Dd, Dd^Ftd, Dd, Dd, Dd, Dd^Edp, Dd, Dd, Dd, Mdd, Hd, Mdd, Mdd, Mdd^Xm, Cd, Mdd^Xm, Hd, Hd, Mdd, Mdd, Mdd, Mdd, Mdd, Mdd^Xm, Mdd^Xm, Xu, Qxua, Uh, Uh, Tb^Tf, Uu, Urb, Urb, Tb^Tf, Tb^Tf, Xu, Qxua, Xos, Xos, Urb, Xos, Xos, Urb, Urb, Xos, Urb^Pr|, Xos, Urb, Xos, Mdd^Xm, Xoa, Hd, Hd, Mdd^Xm, Mdd^Xm, Mdd^Xm, Mdd, Cd, Cd, Cd, Dd^Esd, Dd, Dd, Dd, Dd, Dd, Dd, Dd, Dd, Dd, Dd^Ftd, Dd, Dd, Dd, Dd^Edp
Dd, Dd, Rd, Dd, Dd, Dd, Dd, Dd, Dd, Dd, Dd, Dd, Dd, Dd, Dd, Hd, Mdd, Mdd, Mdd, Mdd^Xm, Hd, Hd, Mdd^Xm, Mdd^Xm, Mdd, Mdd, Mdd, Mdd, Mdd, Mdd, Mdd^Xm, Xu, Uu, Ur, Uu, Uh, Tb^Tf, Tb^Tf, Uu, Uu, Uu, Tb^Tf, Xu, Xu, Xos, Urb, Urb, Urb, Urb^Pr/, Xos, Urb, Xos, Urb, Xos, Urb^Pr\, Xos, Mdd^Xm, Mdd^Xm, Mdd, Cd, Mdd, Mdd^Xm, Mdd, Mdd, Cd, Kd, Cd, Dd, Dd, Dd, Dd, Dd, Dd, Dd, Rd, Dd, Dd^Edp, Dd, Dd^Esd, Dd, Dd, Dd
Dd, Dd, Dd, Dd^Ftd, Dd, Dd, Dd, Dd, Dd, Dd, Dd, Dd, Dd, Dd^Dr, Dd, Hd, Dd, Mdd, Mdd, Mdd, Mdd, Mdd^Xm, Mdd, Mdd, Mdd, Mdd, Mdd, Mdd, Mdd^Xm, Mdd^Xm, Xu, Xu, Uu, Ur, Uu, Uu, Urb, Urb, Uu, Tb, Xu, Xu, Mdd^Xm, Mdd^Xm, Mdd^Xm, Xos, Xos, Xos, Urb, Xos, Urb, Urb, Urb, Urb, Xos, Xos, Mdd^Xm, Mdd^Xm, Mdd, Mdd, Hd, Mdd, Hd, Hd, Dd^Ftd, Cd, Dd^Ftd, Dd, Dd, Dd, Dd, Dd, Dd, Dd, Dd, Dd, Dd, Dd, Dd, Dd^Ftd, Hd, Dd
Dd, Dd, Dd, Dd^Edpp, Dd, Dd, Dd, Dd, Dd^Ftd, Dd, Dd, Dd, Dd^Edp, Dd, Dd^Ftd, Dd, Hd, Hd, Mdd, Mdd^Xm, Mdd^Xm, Mdd, Hd, Mdd, Hd, Mdd, Mdd, Mdd, Mdd^Xm, Xu, Tb, Urb, Uh, Urb, Tb, Tb, Urb, Tb, Xu, Tb, Xu, Mdd^Xm, Mdd^Xm, Mdd^Xm, Xos, Xos, Urb^Pr\, Urb, Urb, Xos, Urb, Cud, Urb, Xos, Mdd^Xm, Mdd^Xm, Hd, Mdd, Dd, Cd, Cd, Hd, Mdd, Mdd^Xm, Mdd, Mdd, Mdd, Dd^Ftd, Hd, Dd, Dd, Dd, Dd^Edp, Dd, Rd, Dd, Dd, Dd, Dd, Dd, Dd, Dd
Dd, Dd, Dd, Dd, Dd, Dd, Rd, Dd, Dd, Hd, Dd, Dd^Edp, Dd, Dd, Mdd^Xm, Hd, Mdd, Mdd^Xm, Mdd^Xm, Hd, Dd^Ftd, Mdd, Mdd, Hd, Rd, Hd, Dd^Vda, Mdd, Hd, Xu, Tb, Uh, Ur, Ur, Uu, Uu, Uh, Uh, Xu, Xu, Mdd^Xm, Mdd^Xm, Mdd^Xm, Xos, Xos, Urb, Urb, Xos, Xos, Urb, Xos, Urb, Cd, Hd, Dd, Dd^Vda, Dd^Ftd, Dd^Ftd, Wwt, Hd, Hd, Mdd, Mdd, Mdd^Xm, Mdd^Xm, Mdd, Mdd, Mdd, Hd, Dd, Dd^Edpp, Dd, Hd, Dd, Dd, Dd, Dd^Ftd, Dd, Dd, Rd, Dd, Dd
Dd, Dd, Hd, Dd, Dd, Dd^Ftd, Rd, Dd, Dd, Dd, Dd, Dd, Hd, Mdd, Mdd, Mdd^Xm, Cd, Hd, Dd, Dd^Vda, Dd^Ftd, Dd^Ftd, Rd, Rd, Dd^Ftd, Rd, Cd, Cd, Cd, Hd, Uu, Tb^Tf, Uh, Ur, Uh, Uu, Xu, Xu, Mdd^Xm, Mdd^Xm, Xoa, Xoa, Xoa, Mdd^Xm, Mdd^Xm, Xos, Xos, Xos, Urb, Urb^Pr\, Xos, Mdd^Xm, Hd, Hd, Rd, Rd, Rd, Dd^Ftd, Dd, Wwt, Dd, Dd^Vda, Mdd, Mdd^Xm, Mdd^Xm, Mdd, Cd, Mdd, Dd, Dd, Dd^Edp, Dd, Dd^Ftd, Dd, Dd, Dd, Dd^Ftd, Dd, Dd, Mdd, Rd, Dd^Edp
Dd, Hd, Dd^Edpp, Dd, Dd, Dd^Ftd, Dd, Dd, Dd, Dd, Hd, Mdd^Xm, Mdd, Hd, Cd, Cd, Rd, Dd^Vda, Dd^Ftd, Dd, Dd, Rd, Dd^Vda, Dd^Ftd, Dd, Dd^Vda, Cd, Kd, Cd, Hd, Hd, Uu, Uh, Uu, Uh, Xu, Mdd^Xm, Mdd^Xm, Mdd^Xm, Xoa, Rb, Rb, Rb, Xoa, Mdd^Xm, Mdd^Xm, Mdd^Xm, Xos, Xos, Xos, Mdd^Xm, Mdd^Xm, Hd, Dd, Dd^Ftd, Dd^Ftd, Dd^Ftd, Hd, Hd, Dd, Mdd, Hd, Hd, Mdd, Dd^Ftd, Cd, Cd, Dd, Hd, Dd, Dd, Dd, Dd^Edp, Dd, Rd, Dd, Dd, Dd, Dd, Dd, Dd, Dd
Dd, Dd, Dd, Dd, Dd, Dd^Edp, Dd, Dd, Dd, Hd, Mdd^Xm, Mdd, Hd, Hd, Dd^Vda, Dd, Rd, Dd^Ftd, Dd^Ftd, Dd^Vda, Rd, Rd, Dd^Ftd, Dd^Ftd, Dd, Dd^Ftd, Dd^Ftd, Cd, Rd, Hd, Hd, Uh, Xu, Uu, Xu, Xu, Mdd^Xm, Mdd^Xm, Mdd^Xm, Xoa, Rb, Rb, Rb, Xoa, Mdd^Xm, Mdd^Xm, Mdd^Xm, Mdd^Xm, Mdd^Xm, Mdd^Xm, Mdd^Xm, Mdd, Hd, Dd^Vda, Rd, Hd, Mdd, Mdd, Mdd, Mdd, Mdd^Xm, Mdd, Mdd, Dd^Ftd, Dd^Ftd, Rd, Rd, Hd, Mdd^Xm, Hd, Mdd, Dd, Dd, Dd, Dd, Dd, Dd, Dd, Dd, Dd^Edpp, Dd, Dd
Dd, Dd, Dd, Dd^Ftd, Dd, Dd, Dd, Dd^Ftd, Dd, Hd, Mdd, Mdd^Xm, Dd^Ftd, Dd^Ftd, Hd, Dd, Dd^Ftd, Rd, Rd, Rd, Dd^Ftd, Dd^Vda, Dd, Dd, Dd^Vda, Dd^Ftd, Rd, Dd^Vda, Rd, Rd, Rd, Mdd^Xm, Mdd^Xm, Xu, Mdd^Xm, Mdd^Xm, Mdd, Hd, Mdd^Xm, Xoa, Xoa, Rb, Cd, Xoa, Mdd^Xm, Mdd^Xm, Mdd, Mdd, Hd, Mdd, Mdd, Mdd, Rd, Rd, Dd^Ftd, Hd, Mdd^Xm, Mdd^Xm, Mdd^Xm, Mdd^Xm, Xoa, Mdd^Xm, Mdd^Xm, Mdd, Mdd, Hd, Rd, Mdd, Mdd, Mdd^Xm, Mdd^Xm, Hd, Dd, Dd, Dd, Dd, Dd, Dd, Dd, Dd, Dd, Dd
Dd, Dd, Dd, Dd, Dd, Dd^Edp, Dd, Dd, Mdd, Mdd^Xm, Mdd, Hd, Dd, Dd^Vda, Dd^Ftd, Hd, Dd^Ftd, Dd^Ftd, Rd, Dd^Ftd, Dd^Ftd, Dd^Ftd, Rd, Rd, Rd, Rd, Wwt, Rd, Dd^Vda, Dd^Ftd, Cd, Cd, Cd, Hd, Mdd, Mdd^Xm, Mdd^Xm, Mdd, Hd, Mdd^Xm, Mdd^Xm, Cd, Hd, Mdd^Xm, Mdd, Mdd^Xm, Mdd, Mdd, Dd^Ftd, Hd, Rd, Hd, Dd, Dd^Ftd, Hd, Mdd, Mdd, Mdd^Xm, Xoa, Xoa, Rb, Xoa, Xoa, Mdd^Xm, Mdd^Xm, Hd, Dd^Vda, Mdd, Hd, Mdd^Xm, Mdd^Xm, Mdd, Dd, Dd^Dr, Dd, Dd, Dd^Ftd, Dd, Dd, Dd, Dd, Dd^Esd
Dd, Rd, Dd, Dd, Dd, Dd, Dd, Dd, Hd, Mdd, Hd, Hd, Dd^Ftd, Hd, Dd^Ftd, Dd, Rd, Rd, Cdr, Rd, Rd, Rd, Dd^Ftd, Dd^Ftd, Dd^Ftd, Wwt, Wwt, Dd^Ftd, Dd^Ftd, Dd^Ftd, Cd, Kd, Cd, Hd, Hd, Mdd, Mdd, Mdd^Xm, Mdd, Hd, Mdd, Hd, Hd, Mdd, Mdd, Mdd, Hd, Dd^Ftd, Dd^Vda, Rd, Dd^Ftd, Dd, Wwt, Dd, Dd^Vda, Hd, Mdd, Mdd^Xm, Xoa, Rb, Rb, Rb, Hd, Mdd^Xm, Mdd, Dd, Rd, Rd, Dd^Ftd, Mdd, Hd, Hd, Dd, Dd, Dd, Dd^Dc, Hd, Dd, Dd, Dd^Ftd, Dd, Dd
Dd, Dd, Dd, Dd, Dd, Dd, Dd, Dd, Hd, Mdd^Xm, Mdd^Xm, Dd^Ftd, Dd^Ftd, Hd, Dd^Vda, Dd, Rd, Cdr, Kd, Cdr, Rd, Dd^Vda, Wwt, Wwt, Wwt, Wwt, Wwt, Dd^Ftd, Dd^Ftd, Dd, Dd^Vda, Cd, Mdd, Mdd, Hd, Mdd, Mdd, Mdd^Xm, Mdd, Hd, Cd, Cd, Cd, Dd^Vda, Hd, Mdd, Cd, Dd, Rd, Rd, Dd^Ftd, Wwt, Wwt, Wwt, Dd^Ftd, Hd, Mdd, Mdd^Xm, Xoa, Rb, Rb, Rb, Mdd, Hd, Mdd, Mdd, Dd^Vda, Dd^Ftd, Wwt, Dd, Cd, Mdd, Hd, Dd, Dd, Dd, Dd, Dd, Dd, Rd, Dd, Dd
Dd, Dd, Dd, Dd, Dd, Dd, Dd, Dd^Ftd, Dd, Mdd, Cd, Rd, Rd, Dd, Dd^Ftd, Dd^Ftd, Rd, Cdr, Cdr, Cdr, Rd, Dd, Dd^Ftd, Wwt, Dd^Ftd, Wwt, Wwt, Wwt, Wwt, Wwt, Wwt, Hd, Hd, Mdd, Mdd, Mdd, Mdd, Mdd^Xm, Mdd, Dd^Vda, Cd, Kd, Cd, Dd^Ftd, Dd^Ftd, Hd, Cd, Cd, Hd, Dd, Dd^Ftd, Dd^Ftd, Hd, Dd^Ftd, Dd^Ftd, Mdd, Mdd, Mdd^Xm, Mdd^Xm, Xoa, Xoa, Hd, Hd, Mdd, Kd, Mdd, Hd, Wwt, Wwt, Dd, Hd, Mdd, Mdd^Xm, Mdd^Xm, Hd, Hd, Dd, Dd, Dd, Dd, Dd, Dd
Mdd, Hd, Dd, Dd^Ftd, Dd, Dd, Dd, Dd, Hd, Hd, Mdd^Xm, Cd, Dd, Rd, Rd, Rd, Dd^Ftd, Rd, Rd, Rd, Rd, Dd^Vda, Dd^Ftd, Dd^Ftd, Wwt, Wwt, Wwt, Wwt, Dd^Ftd, Wwt, Dd, Dd^Ftd, Dd^Ftd, Hd, Mdd, Mdd, Mdd, Mdd^Xm, Mdd, Hd, Hd, Cd, Dd^Vda, Dd^Ftd, Wwt, Dd, Hd, Mdd, Mdd^Xm, Hd, Dd, Hd, Dd, Rd, Dd^Vda, Hd, Mdd, Mdd, Mdd, Mdd^Xm, Mdd^Xm, Mdd^Xm, Mdd, Mdd, Hd, Mdd, Hd, Dd^Ftd, Dd^Ftd, Dd, Mdd, Mdd^Xm, Mdd, Mdd^Xm, Mdd^Xm, Dd, Dd, Dd, Dd, Dd, Dd, Dd
Dd, Dd, Dd, Dd, Hd, Dd, Dd, Dd^Edpp, Mdd, Mdd^Xm, Mdd, Hd, Dd^Ftd, Dd, Dd, Dd^Ftd, Dd^Vda, Dd^Ftd, Rd, Dd, Dd^Ftd, Rd, Rd, Dd^Ftd, Dd, Wwt, Wwt, Dd^Ftd, Dd^Ftd, Rd, Dd^Vda, Dd^Ftd, Dd^Ftd, Hd, Mdd, Mdd, Mdd^Xm, Mdd^Xm, Mdd, Dd^Ftd, Dd^Ftd, Dd, Wwt, Wwt, Wwt, Hd, Mdd^Xm, Mdd^Xm, Mdd, Mdd^Xm, Cd, Kd, Dd, Rd, Rd, Hd, Dd^Ftd, Dd^Ftd, Hd, Mdd, Mdd, Mdd^Xm, Mdd, Hd, Dd^Ftd, Dd, Rd, Dd^Ftd, Rd, Hd, Hd, Mdd, Hd, Hd, Hd, Dd, Dd, Dd, Dd, Dd, Dd, Dd
Dd, Dd, Rd, Dd^Do, Dd, Dd^Ftd, Dd, Dd, Hd, Mdd, Mdd^Xm, Hd, Dd^Ftd, Dd^Vda, Dd^Ftd, Hd, Hd, Dd^Ftd, Rd, Dd^Vda, Dd^Ftd, Dd^Ftd, Rd, Dd, Dd^Ftd, Wwt, Dd^Vda, Dd^Ftd, Rd, Rd, Hd, Hd, Hd, Hd, Mdd, Mdd, Mdd^Xm, Mdd, Hd, Hd, Dd^Ftd, Dd, Dd^Ftd, Wwt, Dd^Ftd, Dd, Cd, Mdd, Hd, Hd, Cd, Cd, Cd, Dd^Ftd, Dd^Ftd, Dd, Wwt, Dd^Ftd, Dd^Vda, Hd, Mdd, Mdd, Hd, Dd^Ftd, Rd, Hd, Dd^Vda, Rd, Cd, Kd, Dd^Ftd, Dd^Ftd, Cd, Cd, Cd, Dd, Dd^Dr, Dd, Dd, Dd^Ftd, Dd, Dd
Dd^Ftd, Dd, Dd, Dd, Dd, Dd, Dd, Dd, Hd, Mdd^Xm, Mdd, Dd^Ftd, Dd, Dd, Dd^Ftd, Dd^Ftd, Rd, Rd, Wwt, Wwt, Wwt, Dd, Dd^Vda, Rd, Dd^Ftd, Dd^Ftd, Rd, Rd, Dd, Dd^Vda, Mdd, Mdd^Xm, Mdd, Mdd^Xm, Mdd^Xm, Mdd^Xm, Mdd^Xm, Mdd^Xm, Cd, Dd, Dd, Dd^Vda, Mdd, Dd^Ftd, Cd, Kd, Cd, Dd, Dd, Dd, Hd, Hd, Mdd^Xm, Hd, Mdd, Dd, Dd, Wwt, Dd^Ftd, Rd, Dd^Ftd, Hd, Dd^Ftd, Rd, Dd^Ftd, Dd^Ftd, Hd, Cd, Hd, Cd, Dd, Dd^Ftd, Cd, Kd, Cd, Hd, Dd, Dd, Dd, Dd, Dd, Dd
Dd, Dd, Dd^Edp, Dd, Dd, Dd, Dd^Ftd, Hd, Mdd^Xm, Hd, Hd, Dd, Dd^Ftd, Hd, Rd, Rd, Dd^Vda, Dd, Wwt, Wwt, Wwt, Dd^Ftd, Dd^Ftd, Rd, Dd, Dd, Rd, Dd^Ftd, Hd, Mdd, Mdd, Mdd^Xm, Mdd, Mdd, Mdd, Mdd, Mdd, Mdd, Cd, Kd, Cd, Mdd, Mdd^Xm, Mdd, Hd, Cd, Dd, Dd, Dd, Rd, Mdd, Mdd, Mdd, Mdd^Xm, Mdd^Xm, Hd, Cd, Dd^Ftd, Dd^Ftd, Dd, Rd, Dd^Ftd, Dd^Vda, Rd, Hd, Mdd, Mdd^Xm, Hd, Mdd^Xm, Hd, Cd, Dd, Dd, Cd, Dd, Hd, Dd, Dd^Ftd, Dd, Dd, Dd, Hd
Rd, Rd, Dd, Dd, Dd, Dd, Hd, Mdd^Xm, Mdd, Hd, Dd^Ftd, Dd^Vda, Dd^Ftd, Dd^Ftd, Rd, Dd^Ftd, Hd, Dd^Ftd, Dd^Ftd, Wwt, Wwt, Wwt, Wwt, Rd, Dd^Ftd, Dd^Ftd, Rd, Dd^Ftd, Hd, Mdd, Mdd^Xm, Mdd^Xm, Mdd, Mdd, Hd, Mdd, Hd, Hd, Dd, Cd, Hd, Mdd, Mdd, Hd, Hd, Hd, Dd, Dd, Dd, Dd, Hd, Mdd, Hd, Mdd^Xm, Mdd, Mdd, Cd, Cd, Mdd, Dd, Dd^Ftd, Rd, Cd, Hd, Mdd, Mdd^Xm, Mdd, Mdd^Xm, Mdd, Cd, Cd, Cd, Mdd, Hd, Mdd^Xm, Dd, Dd, Dd, Dd, Dd, Dd, Dd
Dd, Dd, Dd, Dd, Dd, Dd, Mdd^Xm, Mdd, Mdd, Hd, Dd^Ftd, Dd, Rd, Rd, Dd^Ftd, Hd, Wwt, Dd^Ftd, Wwt, Wwt, Wwt, Wwt, Dd^Ftd, Rd, Rd, Rd, Dd^Ftd, Rd, Hd, Cd, Hd, Hd, Dd, Dd, Dd, Dd, Dd^Ftd, Dd, Dd, Dd^Ftd, Dd, Hd, Dd, Dd, Dd^Esd, Dd, Hd, Dd, Dd^Edpp, Dd, Dd, Hd, Dd^Dr, Mdd, Hd, Hd, Mdd, Mdd^Xm, Mdd^Xm, Hd, Hd, Cd, Kd, Cd, Hd, Mdd, Mdd, Hd, Hd, Rd, Rd, Hd, Hd, Mdd^Xm, Mdd^Xm, Hd, Hd, Dd^Esd, Mdd, Dd^Edpp, Dd, Dd
Dd, Dd^Edp, Dd, Dd, Dd^Ftd, Hd, Mdd, Mdd^Xm, Mdd, Dd^Ftd, Dd^Vda, Dd, Rd, Dd^Vda, Dd^Ftd, Dd^Ftd, Wwt, Wwt, Dd^Ftd, Wwt, Wwt, Dd^Ftd, Dd^Ftd, Rd, Dd^Vda, Dd^Ftd, Hd, Mdd^Xm, Mdd^Xm, Mdd^Xm, Hd, Dd, Dd, Dd, Dd^Edpp, Dd^Dc, Rd, Dd, Rd, Dd, Dd, Dd, Dd, Dd, Dd^Ftd, Dd, Hd, Dd, Dd, Dd, Dd, Dd, Hd, Dd, Dd, Hd, Hd, Mdd^Xm, Mdd^Xm, Mdd, Mdd, Cd, Rd, Rd, Hd, Hd, Dd, Dd^Vda, Wwt, Dd^Fts, Dd^Fts, Rd, Hd, Mdd, Mdd, Mdd, Cd, Dd, Hd, Dd, Dd, Dd^Dc
Dd, Dd, Dd^Ftd, Dd, Dd, Hd, Mdd, Mdd, Hd, Hd, Dd^Ftd, Dd^Ftd, Rd, Dd^Ftd, Dd^Ftd, Wwt, Wwt, Dd^Ftd, Dd^Ftd, Wwt, Hd, Hd, Dd^Vda, Rd, Dd^Ftd, Hd, Mdd, Mdd, Mdd, Mdd^Xm, Mdd^Xm, Dd, Rd, Dd, Dd, Dd, Dd^Edpp, Dd, Rd, Dd, Dd^Esd, Dd, Dd, Dd^Ftd, Dd, Dd, Dd^Edpp, Dd, Dd, Dd, Rd, Dd, Dd, Dd, Hd, Mdd^Xm, Mdd^Xm, Mdd, Mdd, Hd, Dd^Fts, Dd^Fts, Rd, Dd, Dd, Dd^Vda, Dd^Vda, Wwt, Wwt, Wwt, Dd^Fts, Rd, Dd, Dd^Vda, Dd^Vda, Cd, Cd, Hd, Mdd^Xm, Hd, Mdd, Dd
Dd, Dd^Esd, Dd, Dd, Rd, Dd, Hd, Mdd^Xm, Mdd, Dd^Vda, Rd, Rd, Dd^Ftd, Dd, Dd^Vda, Dd, Dd^Vda, Dd^Ftd, Dd, Dd^Vda, Dd, Hd, Dd^Ftd, Rd, Rd, Hd, Hd, Cd, Mdd^Xm, Mdd^Xm, Mdd, Mdd, Hd, Dd, Dd, Dd^Esd, Dd, Dd, Dd, Dd, Dd, Dd^Ftd, Dd, Dd, Dd^Do, Dd, Dd, Dd, Dd, Dd, Dd, Dd, Dd, Dd, Mdd, Mdd, Mdd, Mdd, Hd, Dd, Mdd, Dd^Fts, Rd, Dd^Vda, Dd^Fts, Dd^Fts, Hd, Hd, Dd^Vda, Dd, Rd, Rd, Rd, Hd, Rd, Rd, Rd, Mdd, Mdd^Xm, Mdd, Mdd, Mdd
Dd, Dd, Dd^Ftd, Dd, Dd, Dd, Hd, Mdd^Xm, Mdd^Xm, Cd, Rd, Dd^Ftd, Dd^Ftd, Dd, Hd, Dd^Ftd, Dd^Ftd, Dd, Dd^Ftd, Dd, Dd^Ftd, Dd^Ftd, Hd, Hd, Cd, Rd, Kd, Cd, Cd, Mdd, Mdd, Hd, Dd^Dr, Dd, Dd, Dd, Dd^Edp, Dd, Dd, Dd, Mdd, Rd, Dd^Dc, Dd, Dd, Dd, Dd^Ftd, Dd, Dd, Dd, Mdd, Mdd^Xm, Mdd, Hd, Cd, Hd, Dd^Fts, Hd, Dd^Fts, Dd^Vda, Rd, Rd, Dd^Fts, Rd, Rd, Dd^Fts, Rd, Rd, Rd, Rd, Dd^Fts, Dd^Fts, Dd^Vda, Rd, Dd^Fts, Dd^Fts, Dd^Vda, Hd, Mdd^Xm, Mdd, Mdd, Mdd
Dd^Edpp, Dd, Dd, Dd, Dd, Rd, Dd^Ftd, Mdd, Mdd, Cd, Hd, Rd, Mdd, Mdd, Mdd, Hd, Mdd, Mdd^Xm, Mdd^Xm, Hd, Hd, Dd^Ftd, Mdd^Xm, Mdd^Xm, Mdd, Cd, Hd, Dd, Dd^Edp, Hd, Dd, Dd, Dd, Dd, Dd, Dd, Dd, Dd, Dd, Dd, Mdd, Dd, Dd, Dd, Dd^Dc, Dd^Esd, Dd, Dd, Dd, Dd, Mdd, Mdd, Mdd^Xm, Hd, Mdd, Rd, Dd^Fts, Dd^Vda, Dd^Fts, Dd^Fts, Rd, Hd, Wwt, Dd^Vda, Dd^Fts, Rd, Cd, Cd, Cd, Rd, Dd^Vda, Mdd, Mdd, Rd, Hd, Dd^Fts, Hd, Mdd, Mdd, Mdd^Xm, Mdd^Xm, Mdd
Dd, Dd, Dd^Esd, Dd, Dd, Dd, Dd, Rd, Hd, Mdd, Hd, Cd, Cd, Hd, Mdd^Xm, Mdd^Xm, Mdd^Xm, Mdd, Mdd^Xm, Mdd, Mdd, Mdd, Mdd, Mdd^Xm, Mdd, Cd, Dd, Dd, Dd, Dd, Dd, Dd^Edp, Dd, Dd, Dd, Dd, Dd, Hd, Rd, Dd, Dd, Dd, Dd^Edpp, Dd, Dd^Edpp, Dd, Dd, Dd, Dd, Dd, Mdd, Mdd, Mdd, Mdd^Xm, Mdd, Rd, Rd, Mdd, Rd, Rd, Rd, Dd^Fts, Wwt, Wwt, Dd^Fts, Rd, Cd, Kd, Cd, Rd, Dd^Vda, Dd^Fts, Dd^Fts, Rd, Dd^Vda, Dd^Vda, Hd, Hd, Mdd, Mdd^Xm, Mdd, Mdd
Dd, Dd, Dd, Dd^Edpp, Dd, Dd, Dd, Dd, Dd^Edp, Hd, Dd, Dd, Dd, Mdd^Xm, Mdd, Mdd, Mdd, Mdd^Xm, Mdd, Mdd^Xm, Mdd^Xm, Mdd, Mdd^Xm, Mdd^Xm, Mdd, Mdd, Dd, Dd, Dd, Mdd, Dd, Dd, Dd, Dd^Edp, Dd, Dd^Ftd, Dd^Edp, Dd, Dd, Dd, Dd, Dd, Dd, Dd, Dd, Dd, Dd, Dd, Dd, Dd, Mdd, Mdd, Mdd, Mdd^Xm, Hd, Dd^Vda, Dd^Fts, Rd, Dd^Vda, Hd, Rd, Dd^Fts, Hd, Dd^Vda, Rd, Rd, Rd, Cd, Rd, Rd, Rd, Dd^Fts, Rd, Rd, Hd, Dd^Fts, Dd^Fts, Hd, Mdd^Xm, Mdd^Xm, Mdd, Mdd
Dd, Dd, Rd, Dd, Dd, Dd, Dd, Dd^Edp, Dd, Dd, Dd, Dd^Do, Dd, Dd, Dd, Mdd, Mdd, Mdd, Hd, Hd, Hd, Mdd^Xm, Hd, Hd, Dd, Rd, Dd, Dd, Dd, Dd, Dd, Dd, Dd, Dd^Edp, Dd, Dd, Dd, Dd, Dd, Hd, Dd, Dd, Dd, Dd, Dd, Dd, Dd, Dd, Dd, Dd, Hd, Mdd^Xm, Mdd^Xm, Mdd, Hd, Dd^Fts, Dd^Fts, Rd, Dd^Vda, Dd, Dd^Fts, Rd, Rd, Rd, Dd^Vda, Hd, Dd^Vda, Rd, Hd, Dd^Vda, Dd^Fts, Rd, Rd, Dd, Dd^Vda, Dd^Fts, Mdd, Mdd^Xm, Mdd^Xm, Mdd, Mdd, Mdd
Dd^Esd, Dd, Dd, Dd, Dd, Dd, Dd, Dd, Dd, Dd, Dd, Dd, Dd, Dd, Dd, Dd, Dd, Dd, Dd, Dd, Hd, Dd, Dd, Dd^Edpp, Dd, Dd, Dd, Dd, Dd, Dd, Dd, Dd, Dd^Esd, Rd, Dd, Dd, Dd, Dd, Dd, Dd, Dd, Dd, Dd, Dd, Dd, Dd, Dd, Dd, Dd, Dd, Hd, Hd, Mdd, Hd, Dd^Vda, Dd, Rd, Rd, Rd, Dd^Fts, Rd, Rd, Rd, Dd^Vda, Hd, Dd^Fts, Dd^Fts, Rd, Hd, Wwt, Wwt, Dd^Fts, Rd, Dd^Vda, Hd, Hd, Mdd, Mdd^Xm, Mdd, Mdd, Hd, Mdd
Dd, Dd, Dd, Dd, Dd^Ftd, Dd^Edpp, Hd, Dd, Dd, Hd, Dd, Dd, Dd, Dd, Dd^Ftd, Dd, Dd, Dd, Dd, Dd, Dd, Dd, Dd, Rd, Dd, Dd, Dd, Dd, Dd, Dd, Dd, Dd, Dd, Dd, Dd, Dd^Ftd, Dd, Dd, Dd, Dd, Dd, Dd^Ftd, Dd, Dd, Dd, Dd, Dd, Dd, Dd, Dd, Dd, Hd, Hd, Cd, Kd, Rd, Mdd, Hd, Mdd^Xm, Rd, Dd^Vda, Dd^Fts, Rd, Hd, Dd^Vda, Dd^Fts, Rd, Rd, Dd^Fts, Wwt, Hd, Dd^Vda, Rd, Dd, Mdd^Xm, Hd, Mdd, Mdd, Hd, Hd, Dd, Dd
Dd, Dd, Dd, Dd, Dd^Ftd, Dd, Dd, Dd, Dd^Ftd, Dd^Do, Dd, Dd, Dd, Dd, Dd, Dd, Dd, Dd, Dd, Dd^Ftd, Dd, Dd, Dd, Dd, Dd, Dd, Dd, Dd, Dd, Dd, Dd, Hd, Dd, Dd, Dd, Dd, Dd, Dd, Dd, Dd, Dd^Do, Dd, Dd, Dd, Dd, Dd, Dd, Dd, Dd, Dd, Dd, Dd, Dd^Ftd, Cd, Cd, Cd, Mdd, Mdd^Xm, Mdd^Xm, Mdd, Hd, Dd^Fts, Dd^Vda, Rd, Rd, Rd, Dd^Fts, Hd, Dd^Vda, Dd^Fts, Hd, Dd^Fts, Hd, Mdd^Xm, Mdd, Mdd, Mdd, Mdd, Dd^Ftd, Dd, Dd, Dd
Dd, Dd, Dd^Ftd, Dd, Dd, Dd, Dd, Dd, Dd, Dd, Dd, Dd, Hd, Dd^Edp, Dd, Rd, Dd, Dd, Dd, Rd, Hd, Dd, Dd^Esd, Dd, Dd^Ftd, Dd, Dd, Dd, Dd, Dd, Dd, Dd, Hd, Dd, Dd, Dd, Dd^Esd, Dd, Dd, Hd, Dd, Hd, Mdd, Dd, Dd, Dd^Ftd, Dd, Dd, Dd, Dd, Dd, Hd, Dd^Ftd, Dd, Dd, Mdd, Mdd, Mdd, Mdd^Xm, Mdd^Xm, Mdd, Hd, Kd, Cd, Rd, Hd, Dd^Fts, Dd^Fts, Hd, Mdd, Mdd^Xm, Hd, Cd, Mdd, Hd, Mdd, Hd, Mdd, Dd^Ftd, Dd^Ftd, Dd, Dd
Dd, Dd, Dd, Dd, Dd, Dd, Dd^Ftd, Dd, Dd, Dd, Dd, Dd, Dd, Dd, Hd, Dd, Dd^Ftd, Dd, Hd, Dd, Dd, Dd, Dd, Dd, Dd, Dd, Rd, Dd, Dd, Dd, Dd, Dd, Dd, Mdd, Dd, Dd, Dd, Dd, Dd, Dd, Dd, Dd, Dd, Dd, Dd, Dd, Dd, Dd, Dd^Ftd, Dd^Edp, Dd, Dd, Dd^Esd, Dd, Dd^Dc, Dd, Dd, Hd, Hd, Mdd^Xm, Hd, Cd, Cd, Cd, Mdd^Xm, Mdd, Mdd^Xm, Hd, Mdd, Mdd^Xm, Mdd^Xm, Hd, Rd, Hd, Dd^Esd, Hd, Dd, Dd, Dd, Dd, Dd, Dd^Edp
Dd^Edpp, Dd, Dd^Ftd, Dd^Edp, Dd, Dd, Dd, Dd^Esd, Dd, Mdd, Dd, Dd, Dd, Dd, Dd, Dd, Dd, Dd, Dd, Dd, Dd, Dd, Dd^Dc, Dd, Dd, Dd, Dd, Dd, Dd, Dd, Dd, Dd^Ftd, Dd, Dd^Ftd, Dd^Esd, Dd, Dd, Dd, Dd^Esd, Dd, Dd, Dd, Dd^Ftd, Dd, Dd, Dd, Dd, Dd, Dd, Dd, Dd, Dd, Dd^Ftd, Dd, Dd^Edp, Dd, Dd^Edp, Dd, Dd, Dd^Esd, Dd, Dd, Dd, Mdd, Hd, Mdd^Xm, Mdd^Xm, Mdd, Mdd^Xm, Mdd, Hd, Dd, Dd, Rd, Dd^Esd, Dd, Dd, Dd^Edp, Dd, Dd, Dd, Dd
Dd, Dd^Ftd, Dd, Dd, Dd, Dd, Dd^Edp, Dd^Ftd, Dd, Dd, Dd^Edpp, Dd, Dd, Dd^Ftd, Dd, Dd, Dd, Dd, Dd, Dd, Dd, Dd, Dd^Ftd, Dd, Dd, Dd, Rd, Dd, Dd, Dd, Dd, Dd, Dd, Dd, Dd, Dd^Ftd, Dd, Dd, Dd, Dd, Dd, Dd, Dd, Dd, Dd, Dd, Dd^Dr, Dd, Dd, Dd, Dd, Dd, Rd, Dd, Dd, Dd, Dd, Dd, Dd, Dd, Dd^Ftd, Dd, Dd, Hd, Hd, Mdd^Xm, Hd, Mdd^Xm, Mdd, Hd, Dd, Dd, Dd, Dd^Edp, Rd, Dd, Dd, Dd, Hd, Dd, Dd, Dd
Dd^Esd, Dd, Rd, Dd, Mdd, Dd, Dd^Esd, Dd, Dd^Esd, Dd, Dd, Dd^Dc, Dd, Dd, Dd, Dd, Dd, Dd, Dd, Dd, Dd, Dd^Edp, Dd, Dd, Dd, Dd, Dd, Dd, Dd, Dd, Dd, Dd, Dd^Ftd, Dd, Dd, Dd, Dd, Mdd, Dd, Dd, Dd, Dd^Edp, Dd, Dd, Dd, Dd, Dd, Dd, Dd, Dd, Dd, Rd, Hd, Dd, Dd, Rd, Dd, Dd, Dd^Ftd, Dd, Dd, Dd, Dd, Hd, Dd, Dd, Dd, Hd, Dd^Ftd, Dd, Dd, Dd, Dd, Dd, Dd, Rd, Dd, Rd, Rd, Dd, Hd, Dd
