Qxu, Qxu, Qxu, Qxu, Qxu, Qxu, Qxu, Qxu, Qxu, Qxu, Qxu, Qxu, Qxu, Qxu, Qxu, Qxu, Qxu, Qxu, Qxu, Qxu, Qxu, Qxu, Qxu, Qxu, Qxu, Qxu, Qxu, Qxu, Qxu, Qxu, Qxu, Qxu, Qxu, Qxu, Qxu
Qxu, Qxu, Qxu, Qxu, Qxu, Qxu, Qxu, Qxu, Qxu, Qxu, Qxu, Qxu, Qxu, Qxu, Qxu, Qxu, Xoa, Xoa, Xoa, Qxu, Qxu, Qxu, Qxu, Qxu, Qxu, Qxu, Qxu, Qxu, Qxu, Qxu, Qxu, Qxu, Qxu, Qxu, Qxu
Qxu, Qxu, Qxu, Qxu, Qxu, Qxu, Qxu, Qxu, Qxu, Qxu, Qxu, Qxu, Qxu, Qxu, Qxu^Xo, Qxu^Xo, Xoa, Cud, Xoa, Qxu^Xo, Qxu^Xo, Qxu, Qxu, Qxu, Qxu, Qxu, Qxu, Qxu, Qxu, Qxu, Qxu, Qxu, Qxu, Qxu, Qxu
Qxu, Qxu, Qxu, Qxu, Qxu, Qxu, Qxu, Qxu, Qxu, Qxu, Qxu, Qxu, Qxu^Xo, Qxu^Xo, Qxu, Qxu, Aa, Xoa, Wwb, Qxu, Qxu, Qxu^Xo, Qxu^Xo, Qxu, Qxu, Qxu, Qxu, Qxu, Qxu, Qxu, Qxu, Qxu, Qxu, Qxu, Qxu
Qxu, Qxu, Qxu, Qxu, Qxu, Qxu, Qxu, Qxu, Qxu, Qxu, Qxu^Xo, Qxu^Xo, Qxu, Qxu, Aa, Aa, Ias, Ms, Wwbf, Wwb, Wwb, Qxu, Qxu, Qxu^Xo, Qxu^Xo, Qxu, Qxu, Qxu, Qxu, Qxu, Qxu, Qxu, Qxu, Qxu, Qxu
Qxu, Qxu, Qxu, Qxu, Qxu, Qxu, Qxu, Qxu, Qxu^Xo, Qxu^Xo, Qxu, Qxu, Aa, Wwb, Wwb, Aa^Fpa, Ias, Ias, Wwbf, Wwb, Aa, Aa^Fpa, Wwbf, Qxu, Qxu, Qxu^Xo, Qxu^Xo, Qxu, Qxu, Qxu, Qxu, Qxu, Qxu, Qxu, Qxu
Qxu, Qxu, Qxu, Qxu, Qxu, Qxu, Qxu^Xo, Qxu^Xo, Qxu, Qxu, Ai, Wwb, Aa^Fpa, Aa, Aa, Wwbf, Wwb, Aa, Ias, Wwbf, Wwbf, Wwbf, Aa, Ha, Aa^Fpa, Qxu, Qxu, Qxu^Xo, Qxu^Xo, Qxu, Qxu, Qxu, Qxu, Qxu, Qxu
Qxu, Qxu, Qxu, Qxu, Qxu^Xo, Qxu^Xo, Qxu, Qxu, Ai, Wwb, Ias, Wwb, Wwb, Ai, Wwb, Aa, Wwbf, Ias, Wwb, Aa, Aa, Wwb, Wwb, Wwbf, Ms, Aa, Wwb, Qxu, Qxu, Qxu^Xo, Qxu^Xo, Qxu, Qxu, Qxu, Qxu
Qxu, Qxu, Xoa, Qxu^Xo, Qxu, Qxu, Aa, Ias, Wwb, Aa, Aa, Aa, Wwbf, Wwbf, Ias, Aa, Wwb, Wwb, Wwb, Aa, Aa, Wwb, Aa, Aa, Aa^Fpa, Ias, Ias, Aa^Fpa, Ias, Qxu, Qxu, Qxu^Xo, Xoa, Qxu, Qxu
Qxu, Xoa, Cud, Xoa, Aa, Wwbf, Wwb, Aa, Wwbf, Aa, Ias, Ias, Aa, Ias, Ai, Aa, Ms, Wwb, Wwb, Ms, Ias, Ias, Wwb, Aa, Wwb, Ias, Wwbf, Wwb, Wwbf, Wwbf, Ha, Xoa, Cud, Xoa, Qxu
Qxu, Xoa, Xoa, Xoa, Aa, Ai, Aa, Ha, Aa, Aa^Fpa, Wwb, Wwb, Wwb, Aa^Fpa, Wwbf, Ha, Aa, Aa^Fpa, Aa, Ai, Wwb, Ias, Wwb, Ms, Wwb, Ias, Ms, Wwb, Ias, Aa, Aa, Xoa, Xoa, Xoa, Qxu
Qxu, Qxu^Xo, Qxu, Wwb, Wwb, Aa, Aa, Wwb, Wwb, Aa, Wwbf, Wwbf, Wwbf, Wwb, Aa, Wwb, Aa, Wwb, Ias, Aa, Wwb, Wwb, Wwb, Aa, Wwb, Aa^Fpa, Aa, Wwbf, Ias, Aa^Fpa, Wwbf, Aa, Qxu, Qxu^Xo, Qxu
Qxu, Qxu^Xo, Qxu, Ms, Wwbf, Aa, Wwb, Wwb, Wwb, Aa, Ms, Aa, Wwbf, Wwbf, Wwb, Aa, Ms, Ias, Ias, Aa, Aa, Wwb, Wwbf, Aa, Wwbf, Wwbf, Wwb, Ias, Wwb, Aa, Wwbf, Ms, Qxu, Qxu^Xo, Qxu
Qxu, Qxu^Xo, Qxu, Aa, Aa^Fpa, Ms, Aa^Fpa, Aa, Wwb, Aa, Ias, Wwb, Aa, Wwb, Aa^Fpa, Ms, Wwb, Ms, Wwb, Wwb, Wwbf, Ias, Ai, Aa, Ms, Aa, Ai, Wwbf, Ias, Wwb, Ms, Aa, Qxu, Qxu^Xo, Qxu
Qxu, Qxu^Xo, Qxu, Aa, Wwbf, Aa, Wwb, Wwbf, Wwb, Wwb, Ias, Wwbf, Aa, Wwb, Ias, Wwb, Aa^Fpa, Wwb, Aa, Ha, Ias, Ias, Ha, Wwb, Wwb, Wwbf, Ms, Wwb, Ias, Ias, Ms, Wwb, Qxu, Qxu^Xo, Qxu
Qxu, Qxu^Xo, Qxu, Ias, Aa^Fpa, Wwb, Wwbf, Wwbf, Wwbf, Wwbf, Ms, Wwb, Wwbf, Wwbf, Ha, Ias, Wwb, Aa, Wwbf, Ms, Wwb, Ha, Aa, Ai, Ms, Aa, Aa^Fpa, Ha, Aa^Fpa, Ai, Ias, Wwb, Qxu, Qxu^Xo, Qxu
Qxu, Qxu^Xo, Qxu, Ias, Ias, Ai, Aa, Aa^Fpa, Aa^Fpa, Wwb, Wwbf, Ias, Ias, Wwb, Aa, Aa, Cha, Cha, Cha, Wwbf, Ha, Wwbf, Wwb, Wwb, Ias, Wwb, Ias, Aa^Fpa, Wwb, Wwbf, Aa, Ms, Qxu, Qxu^Xo, Qxu
Qxu, Qxu^Xo, Qxu, Wwb, Wwb, Aa, Aa, Ias, Ias, Aa, Wwb, Aa, Wwbf, Wwb, Ias, Ias, Cha, Kha, Cha, Aa, Wwb, Wwb, Aa, Ias, Wwb, Ms, Aa, Ai, Ias, Ha, Aa, Aa^Fpa, Qxu, Qxu^Xo, Qxu
Qxu, Qxu^Xo, Qxu, Aa, Aa, Wwb, Wwb, Wwb, Wwb, Aa, Aa, Wwbf, Wwbf, Aa^Fpa, Aa^Fpa, Wwb, Ms, Cha, Aa, Aa, Ias, Ias, Aa, Ms, Aa, Aa, Ms, Wwbf, Ms, Ias, Wwb, Wwb, Qxu, Qxu^Xo, Qxu
Qxu, Qxu^Xo, Qxu, Aa^Fma, Wwb, Wwb, Ms, Aa, Aa, Ias, Wwb, Wwb, Wwb, Wwbf, Aa, Ias, Ias, Wwb, Wwb, Ha, Wwbf, Wwb, Aa, Wwb, Wwb, Wwbf, Ai, Aa, Wwb, Ias, Wwbf, Ha, Qxu, Qxu^Xo, Qxu
Qxu, Qxu^Xo, Qxu, Wwbf, Wwb, Wwb, Aa^Fpa, Aa^Fpa, Aa, Ms, Wwb, Aa, Wwb, Ms, Ai, Wwb, Aa, Wwbf, Aa^Fpa, Wwb, Aa, Wwb, Aa, Ms, Ias, Ias, Aa, Wwb, Wwbf, Ms, Wwb, Aa^Fpa, Qxu, Qxu^Xo, Qxu
Qxu, Qxu^Xo, Qxu, Wwb, Aa, Aa, Aa, Wwbf, Wwb, Wwbf, Aa^Fpa, Aa^Fpa, Ms, Wwb, Ai, Wwb, Ha, Aa^Fpa, Aa, Aa, Wwbf, Wwb, Aa, Ias, Ms, Wwb, Ai, Aa, Aa, Ms, Aa, Ias, Qxu, Qxu^Xo, Qxu
Qxu, Qxu^Xo, Qxu, Wwb, Ha, Wwb, Aa^Fpa, Aa, Ha, Wwbf, Wwb, Wwbf, Wwb, Ias, Aa^Fpa, Aa^Fpa, Ms, Wwb, Ms, Aa^Fpa, Wwb, Aa, Aa^Fma, Ms, Wwbf, Ha, Ai, Wwb, Wwbf, Ms, Ha, Ias, Qxu, Qxu^Xo, Qxu
Qxu, Qxu^Xo, Xoa, Aa, Wwbf, Aa, Ias, Aa, Wwbf, Wwbf, Wwb, Aa, Wwbf, Wwb, Wwb, Aa, Aa, Wwb, Aa, Wwb, Aa, Aa, Wwb, Ms, Aa^Fpa, Wwbf, Wwb, Aa, Wwb, Wwb, Wwb, Ms, Xoa, Qxu^Xo, Qxu
Qxu, Xoa, Cud, Xoa, Wwb, Wwbf, Ias, Ias, Ms, Wwb, Wwbf, Ha, Wwb, Wwbf, Ias, Aa, Wwb, Wwb, Aa, Ms, Ias, Wwb, Aa, Wwbf, Wwbf, Wwb, Aa^Fpa, Aa, Wwb, Aa, Wwb, Xoa, Cud, Xoa, Qxu
Qxu, Xoa, Xoa, Xoa, Qxu, Aa, Aa, Ias, Wwb, Wwb, Wwb, Aa, Aa, Aa^Fpa, Wwb, Wwb, Ias, Ias, Wwb, Ias, Ms, Wwb, Wwbf, Wwb, Aa, Aa, Aa, Aa, Wwbf, Wwbf, Qxu, Xoa, Xoa, Xoa, Qxu
Qxu, Qxu, Qxu, Qxu^Xo, Qxu^Xo, Qxu, Qxu, Aa, Wwb, Ha, Wwb, Aa, Wwbf, Wwb, Aa, Wwb, Aa^Fpa, Ai, Aa, Aa^Fpa, Wwb, Aa, Ms, Wwb, Wwbf, Ias, Wwb, Ai, Qxu, Qxu, Qxu^Xo, Qxu^Xo, Qxu, Qxu, Qxu
Qxu, Qxu, Qxu, Qxu, Qxu, Qxu^Xo, Qxu^Xo, Qxu, Qxu, Wwb, Ai, Wwbf, Wwbf, Wwbf, Aa, Ms, Ha, Wwb, Aa^Fpa, Aa^Fpa, Aa, Aa^Fpa, Ha, Aa, Ms, Aa, Qxu, Qxu, Qxu^Xo, Qxu^Xo, Qxu, Qxu, Qxu, Qxu, Qxu
Qxu, Qxu, Qxu, Qxu, Qxu, Qxu, Qxu, Qxu^Xo, Qxu^Xo, Qxu, Qxu, Wwb, Ias, Ias, Aa^Fma, Aa, Aa, Ias, Ias, Wwb, Aa^Fma, Wwb, Aa, Wwb, Qxu, Qxu, Qxu^Xo, Qxu^Xo, Qxu, Qxu, Qxu, Qxu, Qxu, Qxu, Qxu
Qxu, Qxu, Qxu, Qxu, Qxu, Qxu, Qxu, Qxu, Qxu, Qxu^Xo, Qxu^Xo, Qxu, Qxu, Ias, Wwb, Aa^Fpa, Ai, Aa, Wwbf, Aa, Wwb, Aa, Qxu, Qxu, Qxu^Xo, Qxu^Xo, Qxu, Qxu, Qxu, Qxu, Qxu, Qxu, Qxu, Qxu, Qxu
Qxu, Qxu, Qxu, Qxu, Qxu, Qxu, Qxu, Qxu, Qxu, Qxu, Qxu, Qxu^Xo, Qxu^Xo, Qxu, Qxu, Wwb, Wwb, Ha, Aa, Wwb, Qxu, Qxu, Qxu^Xo, Qxu^Xo, Qxu, Qxu, Qxu, Qxu, Qxu, Qxu, Qxu, Qxu, Qxu, Qxu, Qxu
Qxu, Qxu, Qxu, Qxu, Qxu, Qxu, Qxu, Qxu, Qxu, Qxu, Qxu, Qxu, Qxu, Qxu^Xo, Qxu^Xo, Qxu, Xoa, Xoa, Xoa, Qxu, Qxu^Xo, Qxu^Xo, Qxu, Qxu, Qxu, Qxu, Qxu, Qxu, Qxu, Qxu, Qxu, Qxu, Qxu, Qxu, Qxu
Qxu, Qxu, Qxu, Qxu, Qxu, Qxu, Qxu, Qxu, Qxu, Qxu, Qxu, Qxu, Qxu, Qxu, Qxu, Qxu^Xo, Xoa, Cud, Xoa, Qxu^Xo, Qxu, Qxu, Qxu, Qxu, Qxu, Qxu, Qxu, Qxu, Qxu, Qxu, Qxu, Qxu, Qxu, Qxu, Qxu
Qxu, Qxu, Qxu, Qxu, Qxu, Qxu, Qxu, Qxu, Qxu, Qxu, Qxu, Qxu, Qxu, Qxu, Qxu, Qxu, Qxu, Xoa, Qxu, Qxu, Qxu, Qxu, Qxu, Qxu, Qxu, Qxu, Qxu, Qxu, Qxu, Qxu, Qxu, Qxu, Qxu, Qxu, Qxu
Qxu, Qxu, Qxu, Qxu, Qxu, Qxu, Qxu, Qxu, Qxu, Qxu, Qxu, Qxu, Qxu, Qxu, Qxu, Qxu, Qxu, Qxu, Qxu, Qxu, Qxu, Qxu, Qxu, Qxu, Qxu, Qxu, Qxu, Qxu, Qxu, Qxu, Qxu, Qxu, Qxu, Qxu, Qxu
