Wog, Wog, Wog, Wog, Wog, Wog, Wog, Wog, Wog, Wog, Wog, Wog, Wog, Wog, Wog, Wog, Wog, Wog, Wog, Wog, Wog, Wog, Wog, Wog, Wog, Wog, Wog, Wog, Wog, Wog, Wog, Wog, Wog, Wog, Wog, Wog, Wog, Wog, Wog, Wog, Wog, Wog, Wog, Wog, Wog, Wog, Wog, Wog, Wog, Wog, Wog, Wog
Wog, Wog, Wog, Wog, Wog, Wog, Wog, Wog, Wog, Wog, Wog, Wog, Wog, Wog, Wog, Wog, Wog, Wog, Wog, Wog, Wog, Wog, Wwg, Wog, Wog, Wog, Wwg, Wog, Wog, Wog, Wog, Wog, Wog, Wog, Wog, Wog, Wog, Wog, Wog, Wog, Wog, Wog, Wog, Wog, Wog, Wog, Wog, Wog, Wog, Wog, Wog, Wog
Wog, Wog, Wog, Wog, Wog, Wog, Wog, Wog, Wog, Wog, Wog, Wog, Wog, Wog, Wog, Wog, Wog, Wog, Wwg, Wwg, Wwg, Wwg, Ds, Wwg, Wwg, Wwg, Ds, Wwg, Wwg, Wog, Wwg, Wog, Wog, Wog, Wwg, Wog, Wog, Wog, Wog, Wog, Wog, Wog, Wog, Wog, Wog, Wog, Wog, Wog, Wog, Wog, Wog, Wog
Wog, Wog, Wog, Wog, Wog, Wog, Wog, Wog, Wog, Wog, Wog, Wog, Wog, Wog, Wog, Wog, Wwg, Wwg, Ds, Ds, Ds, Ds, Ds, Ds, Ds, Ds, Ds, Ds, Ds, Wwg, Ss, Wwg, Wwg, Wwg, Mm^Xm, Wwg, Wwg, Wog, Wog, Wog, Wog, Wog, Wog, Wog, Wog, Wog, Wog, Wog, Wog, Wog, Wog, Wog
Wog, Wog, Wog, Wog, Wog, Wog, Wog, Wog, Wog, Wog, Wog, Wog, Wwg, Wwg, Wwg, Wwg, Ds, Wwf, Wwf, Ds, Wwf, Ds, Cd^Vd, Ds, Ds, Ds, Ds, Cd^Vd, Ds, Ds, Ss, Ss, Mm, Mm^Xm, Mm^Xm, Mm^Xm, Mm, Wwg, Wwg, Wog, Wog, Wog, Wog, Wog, Wog, Wog, Wog, Wog, Wog, Wog, Wog, Wog
Wog, Wog, Wog, Wog, Wog, Wog, Wog, Wog, Wwg, Wwg, Wwg, Wwg, Wwf, Wwf, Wwf, Ds, Ds, Ds, Ds, Wwf, Ds, Wwf, Wwf, Ds, Wwf, Wwf, Wwf, Ds, Ds, Ds, Ds, Ss, Ds, Mm^Xm, Mm^Xm, Mm^Xm, Mm^Xm, Mm, Wwg, Wog, Wog, Wog, Wog, Wog, Wog, Wog, Wog, Wog, Wog, Wog, Wog, Wog
Wog, Wog, Wog, Wog, Wog, Wog, Wwg, Wwg, Ss, Ss, Ds, Ds, Ds, Ds, Ds, Wwf, Ds, Cd^Vd, Ds, Ds, Ds, Ds, Ds, Wwf, Ds, Ds, Ds, Wwf, Wwf, Ds, Ds, Ds, Ds, Mm, Ur, Mm, Mm, Mm, Ds, Wwg, Wwg, Wog, Wog, Wog, Wog, Wog, Wog, Wog, Wog, Wog, Wog, Wog
Wog, Wog, Wog, Wog, Wog, Wog, Wwg, Ss, Ss, Ss, Gs^Ft, Gs^Ft, Gs^Ft, Gs^Ft, Gs^Ft, Ds, Ds, Ds, Ds, Ds, Mm, Ds, Hd, Ds, Hd, Ds, Ds, Ds, Qxu, Qxu, Ds, Ds, Gg, Gg, Gs^Fms, Mm, Gs^Fms, Gs^Fms, Gs^Fms, Ds, Ds, Wwg, Wwg, Wog, Wog, Wog, Wog, Wog, Wog, Wog, Wog, Wog
Wog, Wog, Wog, Wog, Wog, Wog, Wwg, Ss, Gs^Ft, Gs^Ft, Gs^Ft, Cvr^Vhcr, Gs^Ft, Gs^Ft, Gs^Ft, Gs^Ft, Mm^Xm, Mm, Mm^Xm, Mm, Mm, Mm^Xm, Mm^Xm, Hd, Mm, Mm^Xm, Mm, Mm, Qxu, Qxu, Wwf, Ds, Gg, Gs^Fms, Gs^Fms, Gs^Fms, Gs^Fms, Gs^Fms, Gs^Fms, CbsY^Rhx, Ds, Wwg, Wwg, Wog, Wog, Wog, Wog, Wog, Wog, Wog, Wog, Wog
Wog, Wog, Wog, Wog, Wog, Wog, Wwg, Wwg, Gs^Ft, Gs^Ft, Gs^Ft, Gs^Ft, Gs^Ft, Gs^Ft, Ur, Mm, Mm, Mm^Xm, Mm^Xm, Mm^Xm, Mm, Mm, Mm, Mm, Mm, Mm, Mm, Mm, Ur, Qxu, Gs^Fms, Wwf, Gs^Fms, Gg, Gs^Fms, Gs^Fms, Gs^Fms, Gs^Fms, Gs^Fms, Gs^Fms, Gg, Wwg, Wwg, Wog, Wog, Wog, Wog, Wog, Wog, Wog, Wog, Wog
Wog, Wog, Wog, Wog, Wog, Wog, Wwg, Wwg, Wwg, Gs^Ft, Gs^Ft, Gs^Ft, Mm, Mm, Mm^Xm, Mm, Mm, Mm, Mm, Mm, Mm^Xm, Mm^Xm, Mm, Co^Vo, Wwf, Wwf, Wwf, Mm, Gs^Fms, Gs^Fms, Gs^Fms, Wwf, Gs^Fms, Gs^Fms, Gg, Gg, Gg, Gg, Gg, Gg, Gs^Fms, Ds, Ds, Wwg, Wwg, Wog, Wog, Wog, Wog, Wog, Wog, Wog
Wog, Wog, Wog, Wog, Wog, Wog, Wwg, Wwg, Ds, Wwf, Chr^Vhcr, Gg, Mm, Mm^Xm, Mm^Xm, Co^Vo, Mm, Mm^Xm, Mm^Xm, Mm, Co^Vo, Mm^Xm, Ur, Mm, Mm^Xm, Wwf, Mm, Wwf, Hh, Gs^Fms, Gs^Fms, Wwf, Gs^Fms, Gs^Fms, Gg, Gs^Fms, Gs^Fms, Gs^Fms, Gs^Fms, Gs^Fms, CbsY^Rhx, Gs^Fms, Ds, Ds, Wwg, Wwg, Wog, Wog, Wog, Wog, Wog, Wog
Wog, Wog, Wog, Wog, Wog, Wwg, Ds, Ds, Ds, Wwf, Wwf, Gg, Gg, Mm, Mm, Mm, Mm, Mm^Xm, Mm, Mm, Mm, Mm, Gg, Mm, Mm, Mm^Xm, Mm, Wwf, Hh, Hh, Wwf, Wwf, Gg, Gg, Gg, Gs^Fms, Gs^Fms, Gs^Fms, Gs^Fms, Gs^Fms, Gs^Fms, Gs^Fms, Gs^Fms, Ds, Ds, Wwg, Wwg, Wog, Wog, Wog, Wog, Wog
Wog, Wog, Wog, Wog, Wog, Wwg, Ds, Chr^Vhcr, Gg, Gg, Gg, Wwf, Wwf, Gg, Gg, Gg, Gg, Mm, Gg, Gg, Gg, Gg, Gs^Fms, Gg, Gs^Fms, Gg, Gg, Wwf, Wwf, Hh, Wwf, Gg, Gs^Fms, Gs^Fms, Gg, Gs^Fms, Gs^Fms, Gs^Fms, Gg, Gs^Fms, Gg, Gs^Fms, Aa, Ds, Ds, Wwg, Wwg, Wog, Wog, Wog, Wog, Wog
Wog, Wog, Wog, Wog, Wog, Wwg, Ds, Ds, Gs^Fms, Gs^Fms, Chr^Vhcr, Chr^Vhcr, Chr^Vhcr, Wwf, Gs^Fms, Gs^Fms, Gs^Fms, Gg, Gs^Fms, Gs^Fms, Gg, Gs^Fms, Gg, Gs^Fms, Gs^Fms, Gs^Fms, Gs^Fms, Gg, Gg, Wwf, Wwf, Gg, Gll^Fp, Gs^Fms, Gs^Fms, Gg, Gg, Gg, Gs^Fms, Gg, Gs^Fms, Aa, Aa, Aa, Ds, Ds, Wwg, Wog, Wog, Wog, Wog, Wog
Wog, Wog, Wog, Wog, Wog, Wwg, Wwg, Gg, Gs^Fms, Gs^Fms, Gg, Chr^Vhcr, Gs^Fms, Wwf, Gg, Chr^Vhcr, Gg, Gg, Gg, Gs^Fms, Gg, Gg, Mm, Gg, Gg, Gg, Gg, Gg, Gs^Fms, Gg, Wwf, 1 Ch^Vhc, Gg, Gs^Fms, Gg, Gg, Gs^Fms, Gs^Fds, Gs^Fms, Gs^Fms, Aa^Fpa, Aa^Fpa, Aa, Cva^Vea, Aa^Fpa, Ds, Ds, Wwg, Wwg, Wog, Wog, Wog
Wog, Wog, Wog, Wog, Wog, Wwg, Wwg, Wwg, Gg, Gg, Gg, Gs^Fms, Gs^Fms, Wwf, Gg, Gg, Mm, Gg, Mm, Gg, Mm^Xm, Gs^Vht, Mm, Mm^Xm, Mm, Gs^Fms, Gs^Fms, Gs^Fms, Gg, Gg, Gg, Wwf, Wwf, Gg, Gs^Fms, Gg, Mm^Xm, Ur, Mm^Xm, Ms, Ms, Aa, Aa, Aa^Fpa, Aa^Fpa, Ds, Ds, Ds, Wwg, Wwg, Wog, Wog
Wog, Wog, Wog, Wog, Wog, Wog, Wwg, Wwg, Gg, Gs^Fms, Gs^Fms, Gg, Gg, Wwf, Mm, Mm, Mm, Mm, Mm^Xm, Mm^Xm, Mm, Mm, Mm, Mm, Ds, Gg, Gg, Gg, Gg, Gs^Fms, Gs^Fms, Gg, Wwf, Gs^Fms, Gs^Fms, Gs^Fms, Mm, Mm^Xm, Mm^Xm, Ms, Ms^Xm, Aa^Fpa, Aa^Fda, Aa, Aa, Aa, Ds, Ds, Ds, Wwg, Wog, Wog
Wog, Wog, Wog, Wog, Wog, Wog, Wwg, Ds, Chr^Vhcr, Gs^Fms, Gg, Gg, Gs^Fms, Wwf, Wwf, Mm, Mm^Xm, Mm, Mm, Mm, Ds, Ds, Ds, Ds, Ds, Ds, Ds, Ds, Ds, Gg, Gg, Gg, Wwf, Gs^Fms, Mm, Mm, Mm^Xm, Mm^Xm, Hh^Fmf, Hh^Fmf, Ms^Xm, Aa^Fda, Aa^Fpa, Aa, Aa, Aa^Fda, Ds, Ds, Ds, Wwg, Wog, Wog
Wog, Wog, Wog, Wog, Wog, Wog, Wwg, Ds, Ds, Gg, Mm, Mm, Mm, Gs^Fms, Wwf, Ds, Ds, Ds, Ds, Ds, Ds, Ds, Ds, Cdr^Vdr, Ds, Ds, Ds, Ds, Wwf, Ds, Wwf, Wwf, Gs^Fms, Gg, Ur, Mm, Mm, Mm^Xm, Ms^Xm, Ms^Xm, Ms^Xm, Aa^Fda, Aa^Fpa, Aa^Fpa, Wwbf, Aa^Fpa, Aa^Fpa, Ds, Wwg, Wwg, Wog, Wog
Wog, Wog, Wog, Wog, Wog, Wog, Wog, Wwg, Ds, Ds, Ds, Mm, Ds, Ds, Wwf, Ds, Ds, Ds, Mdd^Xm, Ds, Ds, Ds, Ds, Ds, Ds, Ds, Wwf, Wwf, Ds, Wwf, Gg, Gs^Fms, Gs^Fms, Gg, Mm, Mm^Xm, Mm, Cf^Vud, Ms, Ms^Xm, Aa^Fda, Aa^Fda, Aa^Fda, Wwbf, Wwb, Aa^Fda, Aa^Fpa, Ds, Wwg, Wwg, Wog, Wog
Wog, Wog, Wog, Wog, Wog, Wog, Wog, Wwg, Wwg, Ds, Ds, Ds, Ds, Ds, Wwf, Cd^Vda, Ds, Mdd, Mdd, Mdd, Ds, Ds, Ds, Ds, Wwf, Wwf, Ds, Ds, Ds, Ds, Ds, Gg, Gg, Mm, Mm^Xm, Mm^Xm, Mm^Xm, Mm^Xm, Ms, Ur, Aa^Fpa, Cva^Vea, Aa^Fda, Aa^Fpa, Cva^Vhca, Cva^Vhca, Aa^Fda, Ai, Wwg, Wwg, Wog, Wog
Wog, Wog, Wog, Wog, Wog, Wog, Wog, Wog, Wog, Wwg, Wwg, Ds, Ds, Wwf, Ds, Ds, Ds, Ds, Ds, Ds, Ds, Ds, Ds, Ds, Wwf, Ds, Ds, Ds, Cd^Vda, Ds, Ds, Ds, Wwg, Mm, Mm, Mm^Xm, Mm, Ms, Aa^Fda, Aa^Fda, Aa^Fpa, Aa^Fpa, Aa^Fda, Aa^Fpa, Ai, Kva, Ai, Ai, Wog, Wog, Wog, Wog
Wog, Wog, Wog, Wog, Wog, Wog, Wog, Wog, Wog, Wog, Wog, Wwg, Wwg, Wwg, Wwg, Ds, Ds, Ds, Ds, Cd^Vda, Ds, Ds, Wwf, Wwf, Ds, Ds, Ds, Ds, Ds, Ds, Ds, Wwg, Wwg, Wwg, Wwg, Mm, Wwg, Ai, Ai, Aa^Fda, Ai, Ai, Ai, Ai, Wog, Ai, Wog, Wog, Wog, Wog, Wog, Wog
Wog, Wog, Wog, Wog, Wog, Wog, Wog, Wog, Wog, Wog, Wog, Wog, Wog, Wog, Wog, Wwg, Wwg, Ds, Ds, Ds, Wwg, Ds, Wwg, Ds, Wwg, Wwg, Wwg, Ds, Ds, Ds, Wwg, Wwg, Wog, Wwg, Wwg, Wwg, Wog, Wog, Wog, Ai, Wog, Wog, Wog, Wog, Wog, Wog, Wog, Wog, Wog, Wog, Wog, Wog
Wog, Wog, Wog, Wog, Wog, Wog, Wog, Wog, Wog, Wog, Wog, Wog, Wog, Wog, Wog, Wog, Wog, Wwg, Wwg, Wwg, Wog, Wwg, Wwg, Wwg, Wog, Wog, Wog, Wwg, Wwg, Wwg, Wog, Wog, Wog, Wog, Wog, Wog, Wog, Wog, Wog, Wog, Wog, Wog, Wog, Wog, Wog, Wog, Wog, Wog, Wog, Wog, Wog, Wog
Wog, Wog, Wog, Wog, Wog, Wog, Wog, Wog, Wog, Wog, Wog, Wog, Wog, Wog, Wog, Wog, Wog, Wog, Wog, Wog, Wog, Wog, Wog, Wog, Wog, Wog, Wog, Wog, Wog, Wog, Wog, Wog, Wog, Wog, Wog, Wog, Wog, Wog, Wog, Wog, Wog, Wog, Wog, Wog, Wog, Wog, Wog, Wog, Wog, Wog, Wog, Wog
