border_size=1
usage=map

Wog, Wog, Wog, Wog, Wog, Wog, Wog, Wog, Wog, Wog, Wog, Wog, Wog, Wog, Wog, Wog, Wog, Wog, Wog, Wog, Wog, Wog, Wog, Wog, Wog, Wog, Wog, Wog, Wog, Wog, Wog, Wog, Wog, Wog, Wog, Wog, Wog, Wog, Wog, Wog, Wog, Wog, Wog, Wog, Wog, Wog, Wog, Wog, Wog, Wog, Wog, Wog, Wog, Wog, Wog, Wog, Wog, Wog, Wog, Wog, Wog, Wog, Wog, Wog, Wog, Wog, Wog, Wog
Wog, Wog, Wog, Wog, Wog, Wog, Wog, Wog, Wog, Wog, Wog, Wog, Wog, Wog, Wog, Wog, Wog, Wog, Wog, Wog, Wog, Wog, Wog, Wog, Wog, Wog, Wog, Wog, Wog, Wog, Wog, Wog, Wog, Wog, Wog, Wog, Wog, Wog, Wog, Wog, Wog, Wog, Wog, Wog, Wog, Wog, Wog, Wog, Wog, Wog, Wog, Wog, Wog, Wog, Wog, Wog, Wog, Wog, Wog, Wog, Wog, Wog, Wog, Wog, Wog, Wog, Wog, Wog
Wog, Wog, Wog, Wog, Wog, Wog, Wog, Wog, Wog, Wog, Wog, Wog, Wog, Wog, Wog, Wog, Wog, Wog, Wog, Wog, Wog, Wog, Wog, Wog, Wog, Wog, Wog, Wog, Wog, Wog, Wog, Wog, Wog, Wog, Wog, Wog, Wog, Wog, Wog, Wog, Wog, Wog, Wog, Wog, Wog, Wog, Wog, Wog, Wog, Wog, Wog, Wog, Wog, Wog, Wog, Wog, Wog, Wog, Wog, Wog, Wog, Wog, Wog, Wog, Wog, Wog, Wog, Wog
Wog, Wog, Wog, Wog, Wog, Wog, Wog, Wog, Wog, Wog, Wog, Wog, Wog, Wog, Wog, Wog, Wog, Wog, Wog, Wog, Wog, Wog, Wog, Wog, Wog, Wog, Wog, Wog, Wog, Wog, Wog, Wog, Wog, Wog, Wog, Wog, Wog, Wog, Wog, Wog, Wog, Wog, Wog, Wog, Wog, Wog, Wog, Wog, Wog, Wog, Wog, Wog, Wog, Wog, Wog, Wog, Wog, Wog, Wog, Wog, Wog, Wog, Wog, Wog, Wog, Wog, Wog, Wog
Wog, Wog, Wog, Wog, Wog, Wog, Wog, Wog, Wog, Wog, Wog, Wog, Wog, Wog, Wog, Wog, Wog, Wog, Wog, Wog, Wog, Wog, Wog, Wog, Wog, Wog, Wog, Wog, Wog, Wog, Wog, Wog, Wog, Wog, Wog, Wog, Wog, Wog, Wog, Wog, Wog, Wog, Wog, Wog, Wog, Wog, Wog, Wog, Wog, Wog, Wog, Wog, Wog, Wog, Wog, Wog, Wog, Wog, Wog, Wog, Wog, Wog, Wog, Wog, Wog, Wog, Wog, Wog
Wog, Wog, Wog, Wog, Wog, Wog, Wog, Wog, Wog, Wog, Wog, Wog, Wog, Wog, Wog, Wog, Wog, Wog, Wog, Wog, Wwg, Wog, Wog, Wog, Wog, Wog, Wog, Wog, Wog, Wog, Wog, Wog, Wog, Wog, Wog, Wog, Wog, Wog, Wog, Wog, Wog, Wog, Wog, Wog, Wog, Wog, Wog, Wog, Wog, Wog, Wog, Wog, Wog, Wog, Wog, Wog, Wog, Wog, Wog, Wog, Wog, Wog, Wog, Wog, Wog, Wog, Wog, Wog
Wog, Wog, Wog, Wog, Wog, Wog, Wog, Wog, Wog, Wog, Wog, Wog, Wog, Wog, Wog, Wog, Wog, Wog, Wwg, Wwg, Ds, Wwg, Wwg, Wwg, Wwg, Wog, Wog, Wog, Wwg, Wog, Wog, Wog, Wog, Wog, Wog, Wog, Wog, Wog, Wog, Wog, Wog, Wog, Wog, Wog, Wog, Wog, Wog, Wog, Wog, Wog, Wog, Wog, Wog, Wog, Wog, Wog, Wog, Wog, Wog, Wog, Wog, Wog, Wog, Wog, Wog, Wog, Wog, Wog
Wog, Wog, Wog, Wog, Wog, Wog, Wog, Wog, Wog, Wog, Wog, Wog, Wog, Wog, Wog, Wog, Wog, Wwg, Ds, Ds, Ds, Ds, Ds, Ds, Ds, Wwg, Wwg, Wwg, Ds, Wwg, Wwg, Wog, Wog, Wog, Wog, Wog, Wog, Wog, Wwg, Wog, Wog, Wog, Wog, Wog, Wog, Wog, Wog, Wog, Wog, Wog, Wog, Wog, Wog, Wog, Wog, Wog, Wog, Wog, Wog, Wog, Wog, Wog, Wog, Wog, Wog, Wog, Wog, Wog
Wog, Wog, Wog, Wog, Wog, Wog, Wog, Wog, Wog, Wog, Wog, Wog, Wog, Wog, Wog, Wog, Wwg, Wwg, Ds, Ds, Ds, Ds, Ds, Ds, Ds, Ds, Ds, Ds, Ds, Ds, Ds, Wwg, Wwg, Wog, Wwg, Wwg, Wwg, Wwg, Ds, Wwg, Wwg, Wog, Wog, Wog, Wog, Wog, Wog, Wog, Wog, Wog, Wog, Wog, Wog, Wog, Wog, Wog, Wog, Wog, Wog, Wog, Wog, Wog, Wog, Wog, Wog, Wog, Wog, Wog
Wog, Wog, Wog, Wog, Wog, Wog, Wog, Wog, Wog, Wog, Wog, Wog, Wwg, Wog, Wwg, Wwg, Wwg, Ds, Ds, Ds, Ds, Ds, Ds, Ds, Ds, Ds, Ds, Ds, Ds, Ds, Ds, Ds, Ds, Wwg, Ds, Ds, Ds, Ds, Ds, Ds, Ds, Wwg, Wwg, Wog, Wog, Wog, Wog, Wog, Wog, Wog, Wog, Wog, Wog, Wog, Wog, Wog, Wog, Wog, Wog, Wog, Wog, Wog, Wog, Wog, Wog, Wog, Wog, Wog
Wog, Wog, Wog, Wog, Wog, Wog, Wog, Wog, Wog, Wog, Wwg, Wwg, Ds, Wwg, Ds, Ds, Wwg, Ds, Ds, Ds, Ds, Ds, Ds, Ds, Ds, Ds, Ds, Ds, Ds, Ds, Ds, Ds, Ds, Wwg, Ds, Ds, Ds, Ds, Mv, Ds, Ds, Ds, Ds, Wwg, Wwg, Wog, Wog, Wog, Wog, Wog, Wog, Wog, Wog, Wog, Wog, Wog, Wog, Wog, Wog, Wog, Wog, Wog, Wog, Wog, Wog, Wog, Wog, Wog
Wog, Wog, Wog, Wog, Wog, Wog, Wog, Wog, Wwg, Wwg, Ds, Ds, Ds, Ds, Ds, Ds, Ds, Wwg, Wwg, Ds, Ds, Ds, Ds, Ds, Ds, Ds, Ds, Ds, Ds, Ds, Ds, Ds, Wwg, Wwg, Ds, Ds, Ds, Md, Md, Md, Ds, Ds, Ds, Ds, Ds, Wwg, Wog, Wog, Wog, Wog, Wog, Wog, Wog, Wog, Wwg, Wwg, Wwg, Wwg, Wwg, Wwg, Wwg, Wog, Wog, Wog, Wog, Wog, Wog, Wog
Wog, Wog, Wog, Wog, Wog, Wog, Wog, Wog, Wwg, Ds, Ds, Ds, Ds, Ds, Mv, Ds, Ds, Ds, Ds, Wwg, Ds, Ds, Ds, Ds, Rr^Vd, Ds, Ds, Ds, Ds, Ds, Ds, Ds, Wwg, Ds, Ds, Ds, Ds, Ds, Ds, Ds, Ds, Ds, Ds, Ds, Ds, Wwg, Wwg, Wog, Wwg, Wog, Wwg, Wwg, Wwg, Wwg, Gs^Ft, Gs^Ft, Gs^Ft, Gs^Ft, Gg, Wwg, Wwg, Wog, Wog, Wog, Wog, Wog, Wog, Wog
Wog, Wog, Wog, Wog, Wog, Wog, Wog, Wwg, Ds, Ds, Ds, Ds, Ds, Md, Md, Md, Ds, Ds, Ds, Wwg, Ds, Ds, Ds, Rr^Vd, Kd, Rr^Vd, Ds, Ds, Ds, Ds, Ds, Ds, Wwg, Ds, Ds, Ds, Ds, Ds, Ds, Ds, Ds, Ds, Gs^Ft, Ds, Ss, Ds, Gs^Ft, Wwg, Mm, Wwg, Gs^Ft, Gs^Ft, Gs^Ft, Gg, Gg, Gs^Ft, Gg, Gs^Ft, Gg, Gs^Ft, Gs^Ft, Wwg, Wog, Wog, Wog, Wog, Wog, Wog
Wog, Wog, Wog, Wog, Wog, Wog, Wog, Wwg, Ds, Ds, Ds, Ds, Ds, Ds, Ds, Ds, Ds, Ds, Ds, Wwg, Ds, Ds, Wwg, Rr^Vd, Rr^Vd, Rr^Vd, Wwg, Wwg, Wwg, Ds, Wwg, Wwg, Ds, Wwg, Ds, Ds, Ds, Ds, Gg, Gg, Gg, Gg, Gg, Gs^Ft, Ss, Ss, Gs^Ft, Mm, Mm, Mm, Mm, Gs^Ft, Gg, Gg, Gs^Ft, Gg, Ch, Gg, Ch, Gg, Gs^Ft, Wwg, Wwg, Wog, Wog, Wog, Wog, Wog
Wog, Wog, Wog, Wog, Wog, Wog, Wog, Wwg, Wwg, Ds, Wwg, Ds, Wwg, Ds, Ds, Ds, Ds, Ds, Ds, Wwg, Wwg, Wwg, Ds, Wwg, Wwg, Wwg, Ds, Ds, Ds, Wwg, Ds, Ds, Ds, Wwg, Wwg, Ds, Ds, Gg, Gg, Gg, Gg, Gg, Gg, Gg, Gs^Ft, Ss, Ss, Mm, Mm, Mm, Mm, Gg, Gs^Ft, Gs^Ft, Gg, Gg, Ch, Kh, Ch, Gg, Gg, Gg, Wwg, Wog, Wog, Wog, Wog, Wog
Wog, Wog, Wog, Wog, Wog, Wog, Wog, Wog, Wog, Wwg, Wog, Wwg, Ds, Wwg, Wwg, Ds, Wwg, Ds, Ds, Ds, Wwg, Ds, Ds, Ds, Ds, Ds, Ds, Ds, Ds, Ds, Ds, Ds, Ds, Ds, Ds, Wwg, Wwg, Wwg, Wwg, Gg, Gg, Gg, Gg, Gg, Gg, Gs^Ft, Ss, Gs^Ft, Gg, Gg, Gg, Gg, Gg, Gs^Ft, Gs^Ft, Gg, Gg, Gg, Gg, Gg, Gs^Ft, Gs^Ft, Gg, Wwg, Wog, Wog, Wog, Wog
Wog, Wog, Wog, Wog, Wog, Wog, Wog, Wog, Wog, Wog, Wog, Wwg, Wwg, Ds, Ds, Wwg, Ds, Wwg, Wwg, Wwg, Ds, Wwg, Wwg, Ds, Ds, Ds, Ds, Ds, Ds, Ds, Ds, Ds, Mm, Mm, Mm, Gg, Kh, Rr^Vhc, Wwg, Gg, Gg, Gg, Gg, Gg, Gg, Gg, Gg, Gg, Gs^Ft, Gs^Ft, Gg, Gs^Ft, Gs^Ft, Gg, Gg, Gg, Gs^Ft, Gs^Ft, Gs^Ft, Gg, Gg, Gs^Ft, Gg, Wwg, Wog, Wog, Wog, Wog
Wog, Wog, Wog, Wog, Wog, Wog, Wog, Wog, Wog, Wog, Wog, Wog, Wwg, Ds, Ds, Ds, Ds, Ds, Ds, Ds, Ds, Ds, Wwg, Ds, Ds, Ds, Ds, Ds, Co, Ds, Mm, Mm, Mm, Mm, Mm, Rr^Vhc, Gs^Ft, Rr^Vhc, Gg, Wwg, Gs^Ft, Gg, Gg, Gg, Mm, Mm, Gg, Gs^Ft, Gs^Ft, Gg, Gg, Gs^Ft, Gg, Gs^Ft, Gg, Gg, Gg, Gs^Ft, Gg, Gg, Gg, Gg, Wwg, Wwg, Wog, Wog, Wog, Wog
Wog, Wog, Wog, Wog, Wog, Wog, Wog, Wog, Wog, Wog, Wog, Wog, Wog, Wwg, Ds, Ds, Gs^Ft, Ds, Gs^Ft, Gs^Ft, Gs^Ft, Ds, Mm, Wwg, Mm, Ds, Mm, Mm, Mm, Mm, Mm, Mm, Mm, Mm, Mm, Mm, Mm, Mm, Gg, Wwg, Gs^Ft, Gs^Ft, Gg, Mm, Mm, Mm, Mm, Gg, Gg, Gg, Ss, Ss, Gll^Ftr, Gg, Gg, Gs^Ft, Gs^Ft, Gg, Gs^Ft, Gs^Ft, Gg, Wwg, Wwg, Wwg, Wog, Wog, Wog, Wog
Wog, Wog, Wog, Wog, Wog, Wog, Wog, Wog, Wog, Wog, Wog, Wog, Wog, Wwg, Gs^Ft, Gs^Ft, Gs^Ft, Gs^Ft, Gs^Ft, Gs^Ft, Gs^Ft, Mm, Mm, Mm, Mm, Mm, Mm, Mm, Mm, Mm, Mm, Mm, Mm, Mm, Mm, Mm, Mm, Gg, Gs^Ft, Wwg, Wwg, Gg, Gs^Ft, Mm, Mm, Mm, Mm, Gs^Ft, Gs^Ft, Gll^Ftr, Ss, Gll^Ftr, Ss, Ss, Gg, Gs^Ft, Gg, Gg, Gg, Gs^Ft, Wwg, Wwg, Wwg, Wog, Wog, Wog, Wog, Wog
Wog, Wog, Wog, Wog, Wog, Wog, Wog, Wog, Wog, Wog, Wog, Wog, Wwg, Wwg, Gs^Ft, Gs^Ft, Gs^Ft, Gs^Ft, Mm, Gs^Ft, Mm, Mm, Mm, Mm, Mm, Mm, Mm^Vo, Mm, Mm, Mm, Mm, Mm^Vo, Ko, Mm^Vo, Mm, Mm, Gg, Gs^Ft, Gg, Gs^Ft, Wwg, Gs^Ft, Gs^Ft, Gg, Mm, Mm, Mm, Mm, Mm, Mm, Mm, Gll^Ftr, Gll^Ftr, Ss, Gll^Ftr, Gg, Gs^Ft, Gg, Wwg, Wwg, Wog, Wwg, Wog, Wog, Wog, Wog, Wog, Wog
Wog, Wog, Wog, Wog, Wog, Wog, Wog, Wog, Wog, Wog, Wog, Wwg, Wwg, Gs^Ft, Gs^Ft, Gs^Ft, Gs^Ft, Gs^Ft, Mm, Mm, Mm^Vo, Mm^Vo, Mm, Mm, Mm, Mm, Ko, Mm^Vo, Mm, Mm, Mm, Mm^Vo, Mm, Mm^Vo, Mm, Gg, Gg, Gg, Gg, Gg, Gg, Wwg, Wwg, Gg, Gg, Mm, Gg, Mm, Mm, Mm, Mm, Gs^Ft, Gs^Ft, Gg, Gg, Gs^Ft, Gg, Wwg, Wog, Wog, Wog, Wog, Wog, Wog, Wog, Wog, Wog, Wog
Wog, Wog, Wog, Wog, Wog, Wog, Wog, Wog, Wog, Wog, Wwg, Wwg, Gg, Gg, Gg, Gg, Gg, Mm, Mm, Mm, Mm, Ko, Mm^Vo, Mm, Mm, Mm^Vo, Mm^Vo, Mm, Mm, Mm, Mm, Mm, Mm, Mm, Gg, Gg, Gg, Gg, Gg, Gg, Ch, Gg, Wwg, Gg, Gg, Gg, Gg, Mm, Mm, Mm, Mm, Gs^Ft, Gg, Gg, Gs^Ft, Gg, Wwg, Wwg, Wog, Wog, Wog, Wog, Wog, Wog, Wog, Wog, Wog, Wog
Wog, Wog, Wog, Wog, Wog, Wog, Wog, Wog, Wog, Wog, Wwg, Gg, Gg, Gg, Gg, Gg, Gg, Mm, Mm, Mm, Mm, Mm^Vo, Mm, Mm, Mm, Mm, Mm, Mm, Mm, Mm, Gg, Mm, Gg, Gg, Gg, Gg, Gg, Gg, Gg, Rr^Vhc, Kh, Rr^Vhc, Wwg, Gg, Gg, Gg, Gg, Mm, Gg, Mm, Mm, Mm, Gg, Gs^Ft, Gg, Gg, Wwg, Wog, Wog, Wog, Wog, Wog, Wog, Wog, Wog, Wog, Wog, Wog
Wog, Wog, Wog, Wog, Wog, Wog, Wog, Wog, Wwg, Wwg, Gg, Gg, Gg, Gg, Gg, Gg, Gg, Mm, Mm, Mm, Mm, Mm, Mm, Mm, Mm, Mm, Mm, Mm, Gg, Gg, Gg, Gg, Gg, Gg, Gg, Gg, Gg, Gg, Gg, Rr^Vhc, Ch, Rr^Vhc, Wwg, Gg, Gg, Gg, Wwg, Gg, Gg, Gg, Gg, Gg, Gg, Gg, Md, Gg, Wwg, Wog, Wog, Wog, Wog, Wog, Wog, Wog, Wog, Wog, Wog, Wog
Wog, Wog, Wog, Wog, Wog, Wog, Wog, Wog, Wwg, Gg, Gg, Gg, Gg, Gg, Gg, Gg, Gg, Gg, Gg, Gg, Gg, Gg, Gg, Mm, Wwg, Mm, Gg, Gg, Gg, Gg, Gg, Gg, Gg, Gg, Gg, Gg, Gg, Gg, Gg, Gg, Wwg, Wwg, Gg, Wwg, Wwg, Wwg, Gg, Wwg, Wwg, Gg, Gg, Gg, Gg, Md, Md, Md, Ds, Wwg, Wwg, Wog, Wog, Wog, Wog, Wog, Wog, Wog, Wog, Wog
Wog, Wog, Wog, Wog, Wog, Wog, Wog, Wwg, Gg, Gg, Gg, Gg, Gg, Gg, Gg, Gg, Gg, Gg, Gg, Gg, Gg, Gg, Gg, Gg, Gg, Wwg, Gg, Gg, Gg, Gg, Gg, Gg, Gg, Gg, Gg, Gg, Gg, Gg, Wwg, Wwg, Gg, Gg, Gg, Gg, Gg, Gg, Gg, Gg, Gg, Wwg, Wwg, Gg, Gg, Md, Md, Md, Ds, Wwrg, Wwrg, Wwg, Wwg, Wog, Wog, Wog, Wog, Wog, Wog, Wog
Wog, Wog, Wog, Wog, Wog, Wog, Wog, Wwg, Gg, Gg, Gs^Vl, Gs^Vl, Gs^Vl, Gg, Gg, Gg, Gg, Gg, Gg, Gg, Gg, Gs^Vl, Gs^Vl, Gg, Gg, Wwg, Gg, Gg, Gg, Gg, Gg, Gg, Gg, Gg, Gg, Gg, Gg, Gg, Wwg, Gg, Gg, Gg, Gg, Gg, Cud, Gg, Mm, Gg, Gg, Gg, Wwg, Gg, Gg, Gg, Wwg, Ds, Wwrg, Ds, Ds, Ds, Wwg, Wog, Wog, Wog, Wog, Wog, Wog, Wog
Wog, Wog, Wog, Wog, Wog, Wog, Wog, Wwg, Gg, Gg, Gs^Vl, Kv, Gs^Vl, Gg, Gg, Gg, Gg, Gg, Gg, Gg, Gs^Vl, Kv, Gg, Gg, Wwg, Wwg, Wwg, Gg, Wwg, Gg, Gg, Gg, Wwg, Gg, Gg, Gg, Wwg, Wwg, Gs^Ft, Gg, Mm, Mm, Mm, Mm, Mm, Mm, Mm, Mm, Mm, Gg, Gg, Wwg, Wwg, Wwg, Wog, Wwg, Wwg, Ds, Wwrg, Wwg, Wog, Wog, Wog, Wog, Wog, Wog, Wog, Wog
Wog, Wog, Wog, Wog, Wog, Wog, Wog, Wwg, Gg, Gg, Gg, Gs^Vl, Gg, Gg, Gg, Gg, Gg, Gg, Gg, Gg, Gg, Gs^Vl, Gg, Wwg, Gg, Gs^Ft, Gg, Wwg, Gs^Ft, Wwg, Wwg, Wwg, Gs^Ft, Wwg, Wwg, Gg, Wwg, Gs^Ft, Gs^Ft, Gg, Mm, Mm, Mm, Mm, Mm, Mm, Mm, Mm, Mm, Gg, Gg, Gg, Gg, Wwg, Wog, Wog, Wwg, Ds, Wwg, Wwg, Wog, Wog, Wog, Wog, Wog, Wog, Wog, Wog
Wog, Wog, Wog, Wog, Wog, Wog, Wog, Wwg, Wwg, Gg, Gg, Gg, Gg, Gg, Gg, Gg, Gg, Gg, Gg, Gg, Ds, Gg, Gg, Wwg, Gg, Gs^Ft, Gs^Ft, Gg, Gs^Ft, Gg, Gg, Gs^Ft, Gs^Ft, Gg, Gg, Wwg, Gs^Ft, Gg, Gg, Gg, Cud, Mm, Mm, Mm, Mm, Mm, Mm, Mm, Mm, Mm, Gg, Gg, Gg, Wwg, Wwg, Wog, Wog, Wwg, Wog, Wog, Wog, Wog, Wog, Wog, Wog, Wog, Wog, Wog
Wog, Wog, Wog, Wog, Wog, Wog, Wog, Wog, Wog, Wwg, Gg, Gg, Gg, Gg, Gg, Gg, Gg, Gg, Ds, Ds, Ds, Ds, Ds, Wwg, Ds, Ds, Ds, Gg, Ds, Gs^Ft, Gg, Gs^Ft, Gg, Gg, Gs^Ft, Wwg, Gs^Ft, Gg, Gs^Ft, Gs^Ft, Mm, Mm, Mm, Mm, Mm, Mm, Mm, Mm, Mm, Mm, Gg, Gg, Gg, Gg, Wwg, Wog, Wog, Wog, Wog, Wog, Wog, Wog, Wog, Wog, Wog, Wog, Wog, Wog
Wog, Wog, Wog, Wog, Wog, Wog, Wog, Wog, Wog, Wwg, Gg, Gg, Gg, Gg, Gg, Gg, Gg, Ds, Ds, Ds, Ds, Ds, Wwg, Wwg, Ds, Ds, Ds, Ds, Ds, Ds, Gg, Gg, Gg, Gs^Ft, Wwg, Wwg, Gg, Gg, Gs^Ft, Mm, Mm, Mm, Mm, Mm, Mm, Mm, Mm, Mm, Gg, Gg, Gg, Gs^Fms, Gg, Gg, Wwg, Wog, Wog, Wog, Wog, Wog, Wog, Wog, Wog, Wog, Wog, Wog, Wog, Wog
Wog, Wog, Wog, Wog, Wog, Wog, Wog, Wog, Wog, Wwg, Gg, Gg, Gg, Gg, Gg, Gg, Ds, Ds, Ds, Ds, Ds, Ds, Wwg, Ds, Ds, Ds, Ds, Ds, Ds, Ds, Ds, Gs^Ft, Gg, Gs^Ft, Wwg, Gs^Ft, Gs^Ft, Gg, Gg, Mm, Mm, Mm, Mm, Mm, Mm, Mm, Mm, Cud, Gs^Fms, Gs^Fms, Gg, Gs^Fms, Gs^Fms, Gg, Gg, Wwg, Wwg, Wog, Wog, Wog, Wog, Wog, Wog, Wog, Wog, Wog, Wog, Wog
Wog, Wog, Wog, Wog, Wog, Wog, Wog, Wog, Wwg, Wwg, Gg, Gg, Gg, Gg, Gg, Gg, Ds, Ds, Ds, Ds, Ds, Ds, Wwg, Ds, Ds, Ds, Ds, Ds, Ds, Ds, Ds, Gs^Ft, Gs^Ft, Gg, Wwg, Gs^Ft, Wwg, Gg, Wwg, Mm, Mm, Mm, Mm, Cud, Mm, Mm, Gg, Gg, Gg, Gs^Fms, Gg, Gg, Gg, Gg, Gs^Fms, Gg, Gg, Wwg, Wwg, Wog, Wog, Wog, Wog, Wog, Wog, Wog, Wog, Wog
Wog, Wog, Wog, Wog, Wog, Wog, Wog, Wog, Wwg, Wwg, Wwg, Gg, Wwg, Gg, Gg, Gg, Wwg, Wwg, Wwg, Ds, Wwg, Wwg, Ds, Wwg, Wwg, Wwg, Wwg, Ds, Ds, Ds, Wwg, Wwg, Wwg, Wwg, Wog, Wwg, Wog, Wwg, Wog, Wwg, Wwg, Wwg, Wwg, Mm, Mm, Mm, Gg, Gs^Fms, Gs^Fms, Gg, Gs^Fms, Gs^Fms, Gs^Fms, Gg, Gg, Gs^Fms, Gs^Fms, Gs^Fms, Gs^Fms, Wwg, Wwg, Wog, Wog, Wog, Wog, Wog, Wog, Wog
Wog, Wog, Wog, Wog, Wog, Wog, Wog, Wwg, Gg, Gs^Ftp, Gs^Ftp, Wwg, Gs^Ftp, Wwg, Wwg, Wwg, Gs^Ftp, Ds, Ds, Wwg, Ds, Ds, Md, Ds, Ds, Ds, Wwg, Ds, Ds, Wwg, Wog, Wog, Wog, Wog, Wog, Wog, Wog, Wog, Wog, Wog, Wog, Wog, Wwg, Wwg, Gs^Fms, Gg, Gs^Fms, Gg, Gs^Fms, Gg, Gs^Fms, Gs^Fms, Gg, Gg, Gg, Gs^Fms, Gg, Gg, Gg, Gg, Wwg, Wog, Wog, Wog, Wog, Wog, Wog, Wog
Wog, Wog, Wog, Wog, Wog, Wog, Wog, Wwg, Gs^Ftp, Gg, Gg, Gg, Gg, Gs^Ftp, Gg, Gs^Ftp, Gs^Ftp, Ds, Ds, Ds, Ds, Md, Md, Md, Ds, Ds, Wwg, Wwg, Wwg, Wwg, Wog, Wog, Wog, Wog, Wog, Wog, Wog, Wog, Wog, Wog, Wog, Wog, Wog, Wwg, Wwg, Gs^Fms, Gg, Gs^Fms, Gg, Gg, Gg, Gg, Gs^Fms, Gs^Fms, Gs^Fms, Gg, Gg, Gs^Fms, Gs^Fms, Gg, Wwg, Wog, Wog, Wog, Wog, Wog, Wog, Wog
Wog, Wog, Wog, Wog, Wog, Wog, Wog, Wwg, Gs^Ftp, Gs^Ftp, Gg, Gs^Vl, Gs^Vl, Gg, Gg, Gs^Ftp, Gg, Gg, Gs^Ftp, Ds, Ds, Ds, Ds, Ds, Ds, Wwg, Wog, Wog, Wog, Wog, Wog, Wog, Wog, Wog, Wog, Wog, Wog, Wog, Wog, Wog, Wog, Wog, Wog, Wwg, Wwg, Wwg, Gg, Gg, Gs^Fms, Gg, Gs^Fms, Gg, Gs^Fms, Gg, Gg, Gg, Gg, Gs^Fms, Gs^Fms, Gg, Gg, Wwg, Wog, Wog, Wog, Wog, Wog, Wog
Wog, Wog, Wog, Wog, Wog, Wog, Wog, Wwg, Gg, Gg, Gs^Vl, Kv, Gg, Gs^Ftp, Gs^Ftp, Gg, Gg, Gs^Ftp, Gs^Ftp, Ds, Ds, Ds, Ds, Ds, Wwg, Wwg, Wog, Wog, Wog, Wog, Wog, Wog, Wog, Wog, Wog, Wog, Wog, Wog, Wog, Wog, Wog, Wog, Wog, Wog, Wog, Wwg, Wwg, Gg, Gs^Fms, Gs^Fms, Gg, Gg, Gg, Gg, Gs^Fms, Gs^Fms, Gs^Fms, Gg, Gg, Gg, Gg, Wwg, Wwg, Wog, Wog, Wog, Wog, Wog
Wog, Wog, Wog, Wog, Wog, Wog, Wog, Wwg, Wwg, Gs^Ftp, Gs^Ftp, Gs^Vl, Gg, Gg, Gg, Gg, Gs^Ftp, Gg, Ds, Ds, Ds, Ds, Ds, Wwg, Wog, Wog, Wog, Wog, Wog, Wog, Wog, Wog, Wog, Wog, Wog, Wog, Wog, Wog, Wog, Wog, Wog, Wog, Wog, Wog, Wog, Wwg, Wwg, Gg, Gg, Gs^Fms, Gg, Gs^Fms, Gs^Fms, Gg, Gg, Gg, Gs^Fms, Gs^Fms, Gg, Gs^Fms, Gs^Fms, Gg, Wwg, Wog, Wog, Wog, Wog, Wog
Wog, Wog, Wog, Wog, Wog, Wog, Wog, Wog, Wog, Wwg, Wwg, Gg, Gs^Ftp, Gs^Ftp, Gs^Ftp, Gg, Gs^Ftp, Gs^Ftp, Ds, Ds, Ds, Ds, Wwg, Wwg, Wog, Wog, Wog, Wog, Wog, Wog, Wog, Wog, Wog, Wog, Wog, Wog, Wog, Wog, Wog, Wog, Wog, Wog, Wog, Wog, Wog, Wog, Wog, Wwg, Gg, Gg, Gg, Gs^Fms, Gg, Gg, Gg, Gg, Gg, Gs^Fms, Gg, Gg, Gg, Gg, Wwg, Wog, Wog, Wog, Wog, Wog
Wog, Wog, Wog, Wog, Wog, Wog, Wog, Wog, Wog, Wog, Wog, Wwg, Wwg, Wwg, Wwg, Wwg, Wwg, Ds, Wwg, Ds, Wwg, Wwg, Wog, Wog, Wog, Wog, Wog, Wog, Wog, Wog, Wog, Wog, Wog, Wog, Wog, Wog, Wog, Wog, Wog, Wog, Wog, Wog, Wog, Wog, Wog, Wog, Wog, Wwg, Gg, Gs^Fms, Gs^Fms, Gg, Gg, Gg, Cud, Gg, Cud, Gg, Gg, Gg, Wwg, Wwg, Wwg, Wog, Wog, Wog, Wog, Wog
Wog, Wog, Wog, Wog, Wog, Wog, Wog, Wog, Wog, Wog, Wog, Wog, Wog, Wog, Wog, Wog, Wog, Wwg, Wog, Wwg, Wog, Wog, Wog, Wog, Wog, Wog, Wog, Wog, Wog, Wog, Wog, Wog, Wog, Wog, Wog, Wog, Wog, Wog, Wog, Wog, Wog, Wog, Wog, Wog, Wog, Wog, Wog, Wwg, Gg, Gs^Fms, Gg, Gg, Gg, Cud, Cud, Cud, Cud, Cud, Gg, Gg, Wwg, Wwg, Wog, Wog, Wog, Wog, Wog, Wog
Wog, Wog, Wog, Wog, Wog, Wog, Wog, Wog, Wog, Wog, Wog, Wog, Wog, Wog, Wog, Wog, Wog, Wog, Wog, Wog, Wog, Wog, Wog, Wog, Wog, Wog, Wog, Wog, Wog, Wog, Wog, Wog, Wog, Wog, Wog, Wog, Wog, Wog, Wog, Wog, Wog, Wog, Wog, Wog, Wog, Wog, Wog, Wwg, Wwg, Gg, Gs^Fms, Gs^Fms, Gg, Cud, Cud, Kud, Cud, Cud, Wwg, Wwg, Wwg, Wwg, Wog, Wog, Wog, Wog, Wog, Wog
Wog, Wog, Wog, Wog, Wog, Wog, Wog, Wog, Wog, Wog, Wog, Wog, Wog, Wog, Wog, Wog, Wog, Wog, Wog, Wog, Wog, Wog, Wog, Wog, Wog, Wog, Wog, Wog, Wog, Wog, Wog, Wog, Wog, Wog, Wog, Wog, Wog, Wog, Wog, Wog, Wog, Wog, Wog, Wog, Wog, Wog, Wog, Wog, Wwg, Gg, Gg, Gg, Wwg, Gg, Gg, Gg, Wwg, Wwg, Wog, Wog, Wog, Wog, Wog, Wog, Wog, Wog, Wog, Wog
Wog, Wog, Wog, Wog, Wog, Wog, Wog, Wog, Wog, Wog, Wog, Wog, Wog, Wog, Wog, Wog, Wog, Wog, Wog, Wog, Wog, Wog, Wog, Wog, Wog, Wog, Wog, Wog, Wog, Wog, Wog, Wog, Wog, Wog, Wog, Wog, Wog, Wog, Wog, Wog, Wog, Wog, Wog, Wog, Wog, Wog, Wog, Wog, Wog, Wwg, Wwg, Wwg, Wwg, Wwg, Wwg, Wwg, Wog, Wog, Wog, Wog, Wog, Wog, Wog, Wog, Wog, Wog, Wog, Wog
Wog, Wog, Wog, Wog, Wog, Wog, Wog, Wog, Wog, Wog, Wog, Wog, Wog, Wog, Wog, Wog, Wog, Wog, Wog, Wog, Wog, Wog, Wog, Wog, Wog, Wog, Wog, Wog, Wog, Wog, Wog, Wog, Wog, Wog, Wog, Wog, Wog, Wog, Wog, Wog, Wog, Wog, Wog, Wog, Wog, Wog, Wog, Wog, Wog, Wog, Wog, Wog, Wog, Wog, Wog, Wog, Wog, Wog, Wog, Wog, Wog, Wog, Wog, Wog, Wog, Wog, Wog, Wog
Wog, Wog, Wog, Wog, Wog, Wog, Wog, Wog, Wog, Wog, Wog, Wog, Wog, Wog, Wog, Wog, Wog, Wog, Wog, Wog, Wog, Wog, Wog, Wog, Wog, Wog, Wog, Wog, Wog, Wog, Wog, Wog, Wog, Wog, Wog, Wog, Wog, Wog, Wog, Wog, Wog, Wog, Wog, Wog, Wog, Wog, Wog, Wog, Wog, Wog, Wog, Wog, Wog, Wog, Wog, Wog, Wog, Wog, Wog, Wog, Wog, Wog, Wog, Wog, Wog, Wog, Wog, Wog
Wog, Wog, Wog, Wog, Wog, Wog, Wog, Wog, Wog, Wog, Wog, Wog, Wog, Wog, Wog, Wog, Wog, Wog, Wog, Wog, Wog, Wog, Wog, Wog, Wog, Wog, Wog, Wog, Wog, Wog, Wog, Wog, Wog, Wog, Wog, Wog, Wog, Wog, Wog, Wog, Wog, Wog, Wog, Wog, Wog, Wog, Wog, Wog, Wog, Wog, Wog, Wog, Wog, Wog, Wog, Wog, Wog, Wog, Wog, Wog, Wog, Wog, Wog, Wog, Wog, Wog, Wog, Wog
Wog, Wog, Wog, Wog, Wog, Wog, Wog, Wog, Wog, Wog, Wog, Wog, Wog, Wog, Wog, Wog, Wog, Wog, Wog, Wog, Wog, Wog, Wog, Wog, Wog, Wog, Wog, Wog, Wog, Wog, Wog, Wog, Wog, Wog, Wog, Wog, Wog, Wog, Wog, Wog, Wog, Wog, Wog, Wog, Wog, Wog, Wog, Wog, Wog, Wog, Wog, Wog, Wog, Wog, Wog, Wog, Wog, Wog, Wog, Wog, Wog, Wog, Wog, Wog, Wog, Wog, Wog, Wog
