Dd, Dd, Dd, Dd, Dd, Dd, Dd, Dd, Dd, Dd, Ds, Dd, Dd, Dd, Dd, Dd, Dd, Dd, Dd, Dd, Dd, Dd, Dd, Dd, Dd, Dd, Dd, Dd, Dd, Dd, Dd, Dd, Dd, Dd, Dd, Ds, Dd, Dd, Dd, Dd, Dd, Dd, Ds, Dd, Gg, Gg, Gg, Gg, Gg, Gg
Dd, Dd, Dd, Dd, Dd, Ds, Ds, Dd, Ds, Ds, Ww, Ds, Ds, Ds, Dd, Dd, Ds, Ds, Ds, Ds, Dd, Dd, Dd, Dd, Dd, Dd, Dd, Dd, Dd, Dd, Dd, Dd, Dd, Ds, Dd, Ds, Dd, Ds, Dd, Dd, Dd, Dd, Dd, Ds, Gg, Gg, Gg, Re^Vct, Gg, Gg
Ds, Ds, Ds, Ds, Ds, Ds, Ww, Ds, Ww, Ww, Wo, Ww, Ww, Ds, Ds, Ds, Ds, Dd, Dd, Ds, Ds, Ds, Ds, Dd, Dd, Dd, Dd, Dd, Dd, Dd, Dd, Dd, Ds, Ds, Dd, Dd, Ds, Ds, Dd, Ds, Dd, Ds^Ecf, Dd, Gg, Ce, Ce, Ce, Gg, Gg^Ecf, Gg
Ds, Ds, Ww, Ww, Ww, Ww, Wo, Ww, Wo, Wo, Ww, Wo, Ww, Ww, Ww, Ww, Ww, Ds, Ds, Ds, Dd, Dd, Ds, Dd, Dd, Dd, Dd, Dd, Dd, Ds, Ds, Ds, Ds, Dd, Ds, Dd, Ds, Dd, Ds, Ds, Dd, Ds, Gg, Gg, Ce, 9 Ke, Ce, Gg, Gg, Gg
Ds, Ww, Wo, Wo, Ww, Wo, Ww, Ww, Ww, Ww, Cmy, Ww, Ww, Wo, Wo, Wo, Wo, Ww, Ww, Ds, Ds, Dd, Ds, Ds, Dd, Dd, Dd, Ds, Ds, Ds, Ds, Ds, Ds, Ds, Cmy, Ds, Ds, Dd, Ds, Dd, Ds, Gg, Re^Vct, Gg, Gg, Ce, Gg, Gg, Gg, Gg
Ww, Ww, Ww, Ww, Cmy, Ww, Cmy, Cmy, Rrc, Rrc, Rrc, Cmy, Rrc, Ww, Ww, Ww, Ww, Ww, Wo, Ww, Ww, Ds, Dd, Ds, Ds, Dd, Ds, Ds, Cmy, Ds, Rd, Cmy, Rd, Rd, Rd, Gg, Gg, Ds, Cmy, Ds, Gg, Gg, Gg, Gg, Gg^Ecf, Gg, Gg, Gg, Gg, Gg
Wo, Wo, Ww, Cmy, Rrc, Rrc, Rrc, Rrc, Rrc, Gg, Gg^Vh, Rrc, Rrc, Cmy, Rrc, Cmy, Cmy, Ww, Ww, Wo, Ww, Ds, Ds, Dd, Ds, Ds, Cmy, Gg, Rd, Rd, Gg, Rd, Gg^Eff, Gg^Eff, Gg^Eff, Rd, Rd, Gg, Cmy, Cmy, Cmy, Gg, Gg, Gg, Gg, Gg, Gg, Re^Vct, Gg, Gg
Ww, Ww, Gs^Fms, Rrc, Gg, Gg^Vh, Gs^Fms, Gg, Rrc, Gs^Fms, Gs^Fms, Gg, Gs^Fms, Rrc, Gs^Fms, Rrc, Rrc, Rrc, Ww, Wo, Ww, Dd, Ds, Ds, Dd, Dd, Gg, Rd, Gs^Vh, Gg, Gg^Eff, Gg^Eff, Re^Gvs, Re^Gvs, Re^Gvs, Gg^Eff, Gg^Eff, Rd, Rd, Cmy, Gg, Gg, Cmy, Gg, Gg, Gg, Gg, Gg, Gg, Gg
Mm^Xm, Mm^Xm, Mm, Rrc, Gg, Gs^Fms, Gs^Fms, Rrc, Kmy, Rrc, Gs^Fms, Gg, Gg, Gs^Fms, Rrc, Gs^Vh, Rrc, Cmy, Ww, Ww, Ww, Cmy, Cmy, Dd, Gg, Gg, Rd, Rd, Gg^Eff, Gg^Eff, Re^Gvs, Re^Gvs, Re^Gvs, Re^Gvs, Re^Gvs, Re^Gvs, Re^Gvs, Gg^Eff, Gg^Eff, Rd, Rd, Gg, Gg, Cmy, Cmy, Cmy, Gg, Gg, Gg, Gg
Mm^Xm, Mm^Xm, Mm, Rrc, Rrc, Rrc, Rrc, Rrc, Cmy^Sr, Rrc, Rrc, Rrc, Rrc, Rrc, Gg, Rrc, Cmy, Ww^Bsb\, Wo^Bsb\, Wo, Ww, Cmy, Gg, Gg, Rd, Rd, Gg^Eff, Gg^Eff, Re^Gvs, Re^Gvs, Re^Gvs, Re^Gvs, Re^Gvs, Re^Gvs, Re^Gvs, Re^Gvs, Re^Gvs, Re^Gvs, Gg^Eff, Gg^Eff, Rd, Gg, Gg, Cmy, Gg, Gg, Cmy, Gg, Gg, Gg
Mm^Xm, Mm^Xm, Mm, Gg^Vh, Rrc, Kmy, Cmy^Sr, Rrc, Cmy^Sr, Rrc, Cmy^Sr, Kmy, Rrc, Gs^Vh, Gg, Rrc, Ww, Ww, Wo, Ww^Bsb\, Rr, Rr, Rr, Rd, Gg^Eff, Gg^Eff, Re^Gvs, Re^Gvs, Re^Gvs, Re^Gvs, Re^Gvs, Re^Gvs, Re^Gvs, Re^Gvs, Re^Gvs, Re^Gvs, Gg^Eff, Gg^Eff, Gg, Rd, Gg^Sr, Gg^Sr, Gg^Sr, Gg, Gg, Cmy, Cmy, Gg, Gg, Gg
Mm, Mm^Xm, Mm^Xm, Gg, Gg, Rrc, Rrc, Cmy^Sr, 2 Kmy, Cmy^Sr, Rrc, Rrc, Gg, Rrc, Rrc, Rrc, Ww, Wo, Wo, Ww, Rr, Cmy, Rr, Gg, Gg^Sr, Gg^Eff, Gg^Eff, Re^Gvs, Re^Gvs, Re^Gvs, Re^Gvs, Re^Gvs, Re^Gvs, Re^Gvs, Gg^Eff, Gg^Eff, Gg, Gg, Gs^Vh, Rd, Gg^Sr, Gg^Sc, Gg^Sr, Gg, Rd, Cmy, Cmy, Gg, Gg, Gg
Mm, Mm^Xm, Mm^Xm, Mm, Rrc, Rrc, Cmy^Sr, Cmy^Sr, Cmy^Sr, Cmy^Sr, Cmy^Sr, Rrc, Rrc, Gg, Gs^Fms, Rrc, Cmy, Ww, Ww^Bsb/, Ww^Bsb/, Ww, Rr, Rr, Gg^Sr, Gg^Sc, Gg^Sr, Gg, Gg^Eff, Gg^Eff, Re^Gvs, Re^Gvs, Re^Gvs, Gg^Eff, Gg^Eff, Gg, Gg, Rd, Rd, Rd, Rd, Rd, Gg^Sr, Gg, Gg, Rd, Gg, Gg, Gg, Gg, Gg
Mm^Xm, Mm^Xm, Mm, Mm, Rrc, Kmy, Rrc, Rrc, Cmy^Sr, Rrc, Rrc, Kmy, Rrc, Gs^Fms, Gs^Fms, Rrc, Rrc, Ww^Bsb/, Ww, Wo, Ww, Cmy, Rr, Gg^Sr, Gg^Sr, Gg^Sr, Rd, Rd, Rd, Gg^Eff, Gg^Eff, Gg^Eff, Gg, Gg, Rd, Rd, Gg, Gg, Gg^Eff, Gg^Eff, Gg^Eff, Rd, Rd, Rd, Gg, Gg, Gg, Gg, Gg, Gg
Mm, Mm^Xm, Mm^Xm, Mm, Mm, Rrc, Gs^Fms, Rrc, Kmy, Rrc, Gs^Fms, Rrc, Gs^Fms, Rrc, Gs^Vh, Gs^Fms, Rrc, Cmy, Ww, Wo, Ww^Bsb/, Ww^Bsb/, Cmy, Rr, Rd, Rd, Gg, Gs^Vh, Gg, Rd, Rd, Gg, Gg, Gs^Vh, Rd, Gg, Gg^Eff, Gg^Eff, Re^Gvs, Re^Gvs, Re^Gvs, Gg^Eff, Gg^Eff, Gg, Gg, Cmy, Cmy, Gg, Gs, Gg
Mm, Mm^Xm, Mm^Xm, Mm, Mm, Gs^Fms, Gs^Fms, Rrc, Rrc, Rrc, Rrc, Rrc, Rrc, Gs^Fms, Gs^Fms, Gs^Fms, Rrc, Cmy, Rrc, Ww^Bsb/, Wo, Ww, Ww, Rr, Cmy, Gg, Gg, Gg, Gg, Gg, Gg, Rd, Rd, Rd, Gg^Eff, Gg^Eff, Re^Gvs, Re^Gvs, Re^Gvs, Re^Gvs, Re^Gvs, Re^Gvs, Gg^Eff, Gg^Eff, Cmy, Cmy, Gg, Gg, Gs, Gg
Mm, Mm, Mm^Xm, Mm^Xm, Mm^Xm, Mm, Gs^Fms, Gs^Fms, Gs^Fms, Gs^Fms, Gs^Fms, Gg^Fet, Gs^Fms, Rrc, Gs^Fms, Rrc, Gs^Fms, Rrc, Mm, Ww, Ww, Wo, Wo, Ww, Ww, Cmy, Gg, Gg, Gg, Gg, Gg, Gg, Rd, Gg, Gg, Gg^Eff, Gg^Eff, Re^Gvs, Re^Gvs, Re^Gvs, Gg^Eff, Gg^Eff, Cmy, Gg, Gg, Cmy, Gg, Gs, Gg, Gg
Mm, Mm, Mm, Mm^Xm, Mm^Xm, Mm, Mm, Gs^Fms, Gs^Fms, Gs^Fms, Gs^Vh, Gs^Fms, Rrc, Rrc, Gs^Fms, Gs^Fms, Mm, Mm, Mm^Xm, Mm^Xm, Hh, Ww, Ww, Ww, Wo, Ww, Cmy, Cmy, Gg, Cmy, Cmy, Gg, Gg, Rd, Rd, Gg, Gg, Gg^Eff, Gg^Eff, Gg^Eff, Gg, Gg, Cmy, Gg, Gg, Gg, Gs, Gg, Gs, Gg
Mm, Mm, Mm, Mm, Mm^Xm, Mm, Mm^Xm, Mm, Mm, Mm, Mm, Rrc, Mm, Mm, Mm, Mm, Mm^Xm, Mm^Xm, Mm, Mm^Xm, Mm^Xm, Hh, Mm, Ww, Wo, Ww, Ww, Cmy, Gg, Gg, Gg, Gg, Gg, Cmy, Cmy, Cmy, Gg, Gg, Cmy, Cmy, Cmy, Cmy, Cmy, Cmy, Gg, Gg, Gg, Gs, Gs, Gg
Mm, Mm, Mm, Mm, Mm, Mm^Xm, Mm^Xm, Mm^Xm, Mm^Xm, Mm, Mm, Mm, Mm, Mm, Mm^Xm, Mm^Xm, Mm^Xm, Hh, Mm, Mm, Mm, Mm, Mm, Ww, Ww, Wo, Wo, Ww, Gg, Gs, Gs, Gg, Gs, Gs, Gs, Gg, Gg, Gg, Gg, Gg, Gg, Gg, Gg, Gg, Gg, Gs, Gs^Ft, Gg, Gs, Gg
Mm, Mm, Mm, Mm, Mm, Mm, Mm^Xm, Mm^Xm, Mm^Xm, Mm^Xm, Mm^Xm, Mm^Xm, Mm^Xm, Mm^Xm, Mm^Xm, Mm, Hh, Hh, Mm, Hh, Hh, Hh, Hh, Mm, Hh, Ww, Wo, Ww, Gg, Gg, Gg, Gs^Ft, Gs^Ft, Gs, Gg, Gs, Gs, Gg, Gg, Gs, Gs^Ft, Gg, Gs^Ft, Gg, Gg, Gs^Ft, Gg, Gs^Ft, Gs, Gg
Mm, Mm, Mm, Mm, Mm, Mm^Xm, Mm, Mm^Xm, Mm, Mm, Mm, Mm, Mm, Mm, Mm^Xm, Hh, Mm, Hh, Hh, Mm, Hh, Mm, Mm, Mm, Hh, Ww, Ww, Ww, Gs^Ft, Gg, Gs, Gs^Ft, Gg, Gs, Gs, Gs^Ft, Gs^Ft, Gs^Ft, Gg, Gg, Gs^Ft, Gs^Ft, Gs, Gs, Gs, Gg, Gg, Gs, Gg, Gg
Mm, Mm, Mm, Mm, Mm^Xm, Mm^Xm, Mm, Mm, Hhd, Mm, Gd, Hhd, Hhd, Mm, Mm, Mm^Xm, Mm, Hh, Hh, Hh, Re, Hh, Hh, Hh, Gg, Ww, Wo, Ww, Gs^Ft, Gs^Ft, Gg, Gs, Gs^Ft, Gg, Gg, Gg, Gg, Gs, Gs, Gs, Gs, Gg, Gs, Gs, Gs^Ft, Gg, Gg, Gs^Ft, Gs^Ft, Gg
Mm, Mm, Mm, Mm^Xm, Mm, Mm, Hhd, Hhd, Co, Co, Co, Gd, Gd^Vo, Hhd, Mm, Mm^Xm, Mm, Mm, Hh, Re, Co, Re, Gg, Gs, Gg, Ww, Wo, Ww, Gg, Gs, Gg, Gs^Ft, Gg, Gs^Ft, Gg, Gg, Gg, Gg, Gs^Ft, Gg, Gs^Ft, Gg, Gg, Gg, Gs^Ft, Gg, Gg, Gs^Ft, Gs^Ft, Gg
Mm, Mm, Mm^Xm, Mm^Xm, Mm, Mm, Hhd, Gd^Vo, Co, Ko, Ko, Co, Gd, Hhd, Mm, Mm^Xm, Mm, Mm, Hh, Re, Re, Re, Gg, Gs, Wwf, Ww, Ww, Ww, Gg, Gg, Gg, Gs, Gs, Gs, Gs^Ft, Gs, Gs, Gg, Gg, Gs^Ft, Gs^Ft, Gs, Gs, Gs^Ft, Gs, Gs, Gs^Ft, Gg, Gg, Gg
Mm, Mm, Mm^Xm, Mm, Mm, Mm, Hhd, Co, Ko, 6 Ko, Co, Co, Hhd, Hhd, Mm, Mm^Xm, Mm^Xm, Hh, Hh, Gg, Gg, Gs, Gg, Ww, Wwf, Ww, Wwf, Ww, Gg, Gs, Gs^Ft, Gs^Ft, Gs^Ft, Gg, Gs^Ft, Gs^Ft, Gs, Gs, Gs, Gg, Gg, Gg, Gg, Gg, Gs, Gg, Gs^Ft, Gs^Ft, Gg, Gg
Mm, Mm, Mm^Xm, Mm, Mm, Hhd, Gd, Co, Co, Ko, Co, Gd, Hhd, Mm, Mm, Mm^Xm, Mm^Xm, Mm, Gg, Gs, Gs, Gg, Gg, Wwf, Ww, Ww, Gg, Gg, Gs, Gs, Gg, Gs^Ft, Gs, Gs, Gs, Gg, Gg, Gg, Gs^Ft, Gs^Ft, Gg, Gg, Gg, Gs, Gs, Gg, Gs, Gg, Gg, Gg
Mm, Mm^Xm, Mm, Mm, Hhd, Hhd, Gd, Re, Gd, Co, Re, Gd^Vo, Hhd, Mm, Hhd, Mm, Mm^Xm, Mm^Xm, Hh, Gg, Gs, Gs, Gg, Wwf, Ww, Wwf, Gg, Gg, Gs, Gg, Gg, Gg, Gg, Gg, Gs^Ft, Gg, Gs^Ft, Gs, Gg, Gs^Ft, Gg, Gg, Ce, Gg, Gg, Gg, Gs, Gs, Gg, Gg
Mm, Mm^Xm, Mm, Mm, Hhd, Hhd, Gd, Re, Re, Gd, Re, Gd, Gd, Hhd, Hhd, Mm, Mm^Xm, Mm, Hh, Gg, Gg, Gg, Gg, Wwf, Wwf, Wwf, Gg, Gs, Gg, Gs, Gs^Ft, Gs, Gg, Gg, Gg, Gs^Ft, Gg, Gg, Gg, Gg, Ce, Ce, Ce^Vct, Ce, Ce, Gg, Gg, Gs, Gg, Gg
Mm, Mm^Xm, Mm, Mm, Hhd, Hhd, Gd, Gd^Vo, Re, Gd, Re, Re, Co, Co, Hhd, Mm, Mm, Mm^Xm, Mm, Hhd, Gs, Gs, Gs, Gg, Wwf, Ww, Gg, Gs, Gg, Gs^Ft, Gg, Gs^Ft, Gs, Gg, Gg, Gs, Gs, Gg, Gg, Gg, Ce, Ce^Vct, Ce^Ecf, Ce, Ce, Ce, Ce, Gg, Gg, Gg
Mm^Xm, Mm^Xm, Mm, Mm, Hhd, Co, Co, Gd, Co, Co, Co, Re, Re, Co, Gd, Hhd, Hhd, Mm, Hh, Hhd, Gg, Gs, Gs, Gg, Ww, Ww, Ww, Gg, Gg, Gg, Gg, Gg, Gg, Gg, Gs, Gg, Gg, Gg, Gs^Ft, Gg, Ce, Ce^Vct, Ce, 3 Ke, Ce^Ecf, Ce^Vct, Ce, Gg, Gs, Gg
Mm^Xm, Mm^Xm, Mm, Hhd, Hhd, Co, Gd, Gd, Gd, Co, Gd, Re, Gd, Gd, Re, Gd, Gd, Hhd, Gg, Gs, Gg, Gg, Gg, Gg, Gg, Ww, Wo, Ww, Gg, Gg, Gs^Ft, Gg, Gs, Gs, Gs^Ft, Gs^Ft, Gs, Gg, Gs^Ft, Gs, Gg, Ce, Ce, Ce, Ce^Vct, Ce^Vct, Ce, Gg, Gs, Gg
Mm^Xm, Mm, Hhd, Hhd, Gd, Re, Re, Gd, Gd, Gd, Gd, Gd, Re, Re, Gd^Vo, Gd, Gs^Ft, Gs^Ft, Gg, Gs, Gg, Gs, Gs, Gg, Gs, Ww, Wo, Ww, Gg, Gg, Gg, Gs^Ft, Gs, Gs, Gg, Gs^Ft, Gs^Ft, Gg, Gg, Gs^Ft, Gg, Gg, Gg, Ce, Ce, Ce, Gg, Gs, Gg, Gg
Mm, Mm, Hhd, Hhd, Gd, Re, Gd, Gd^Vo, Re, Re, Gd, Gd, Re, Gd, Gd, Gd, Gs^Ft, Gs^Ft, Gs^Ft, Gg, Gs^Ft, Gg, Gg, Gs, Gg, Ww, Wo, Ww, Gg, Gs, Gg, Gs^Ft, Gg, Gs, Gg, Gg, Gg, Gg, Gg, Gs, Gs, Gg, Gg, Gg, Gg, Gg, Gs, Gg, Gg, Gg
Hhd, Hhd, Gs^Ft, Gd, Gd, Gs^Ft, Gd, Re, Gd, Gd, Gd, Gd, Gs^Ft, Gs^Ft, Re, Gs^Ft, Re, Gs^Ft, Re, Gs^Ft, Gs, Gs^Ft, Gs^Ft, Gg, Gs, Ww, Ww, Ww, Ww, Gg, Gs, Gg, Gg, Gs, Gg, Gg, Gg, Gg, Gg, Gg, Gg, Gs, Gs, Gs, Gs, Gs, Gg, Gg, Gg, Gg
Hhd, Hhd, Re, Gs^Ft, Gs^Ft, Gs^Ft, Gs^Ft, Gd, Gs^Ft, Gd, Gs^Ft, Gd, Gs^Ft, Re, Gs^Ft, Gs^Ft, Gs^Ft, Re, Gs^Ft, Gs^Ft, Gs, Gs^Ft, Gg, Gs, Gs, Gg, Ww, Wo, Ww, Gg, Gg, Gs, Gg, Gg, Gg, Gs^Ft, Gs^Ft, Gg, Gg, Gs^Ft, Gs^Ft, Gg, Gg, Gg, Gg, Gg, Gg, Gs, Gg, Gs^Ft
Gg, Gs^Ft, Re, Gs^Ft, Re, Gs^Ft, Gs^Ft, Gg, Gs^Ft, Gs^Ft, Gg, Gs, Gs, Gg, Gs, Gs^Ft, Gs^Ft, Gs^Ft, Gg, Gs^Ft, Gs^Ft, Gs^Ft, Gs^Ft, Gs^Ft, Gs, Gg, Ww, Wo, Ww, Gg, Gs, Gs, Gs, Gg, Gs^Ft, Gg, Gg, Gg, Gg^Ve, Gs^Ft, Gg, Gg, Gg, Gs^Ft, Gg, Gs^Ft, Gs^Ft, Gs, Gg, Gs^Ft
Gs^Ft, Gs^Ft, Gs^Ft, Re, Gs^Ft, Gs^Ft, Gs, Gs, Gs^Ft, Gs^Ft, Gg, Gg, Gs^Ft, Gs, Gs, Gs, Gg, Gs^Ft, Gs^Ft, Gg, Gg, Gs^Ft, Gg, Gg, Gg, Gs^Ft, Ww, Wo, Ww, Gg, Gg, Gs, Gg, Gg, Gg^Ve, Gs^Ft, Gg, Gg, Gs^Ft, Gg, Gs^Ft, Gs^Ft, Gs^Ft, Gs^Ft, Gg^Efm, Gs^Ft, Gs^Ft, Gg, Gg, Gg
Gs^Ft, Gg, Gs, Gs^Ft, Gs, Gs^Ft, Gg, Gs^Ft, Gg, Gs^Ft, Gs^Ft, Gg, Gg, Gs^Ft, Gg, Gs^Ft, Gs^Ft, Gg, Gs^Ft, Gs^Ft, Gg, Gs^Ft, Gg^Vo, Gs^Ft, Gs^Ft, Ww, Wo, Ww, Gg, Gs^Ft, Gs^Ft, Gg, Gs, Gs^Ft, Gs^Ft, Gs^Ft, Gs^Ft, Gg, Gs^Ft, Gs^Ft, Gs^Ft, Gg^Efm, Gs^Ft, Gg^Efm, Gs^Ft, Gs^Ft, Gs^Ft, Gs^Ft, Gs^Ft, Gs^Ft
Gg, Gs, Gg, Gg, Gs^Ft, Gs^Ft, Gg, Gs^Ft, Gg, Gs^Ft, Gs^Ft, Gs, Gs^Ft, Gg^Vo, Gg, Gs^Ft, Gg, Gs^Ft, Gg, Gs^Ft, Gs^Ft, Gg, Gs^Ft, Gs^Ft, Gg, Ww, Wo, Ww, Gg, Gs^Ft, Gs^Ft, Gs^Ft, Gs^Ft, Gs, Gs^Ft, Gs, Gs^Ft, Gs^Ft, Gg^Efm, Gg, Gs^Ft, Gs^Ft, Gg, Gs^Ft, Gs^Ft, Gs^Ft, Gs^Ft, Gg^Efm, Gg^Efm, Gs^Ft
Gs^Ft, Gg, Gs^Ft, Gg, Gg, Gs^Ft, Gg, Gs, Gg, Gs^Ft, Gs^Ft, Gs, Gg, Gs^Ft, Gg, Gg, Gg, Gs^Ft, Gg, Gs^Ft, Gg^Vo, Gs^Ft, Gs^Ft, Gs^Ft, Gs^Ft, Ww, Wo, Ww, Gs^Ft, Gg, Gs^Ft, Gs^Ft, Gg^Efm, Gs^Ft, Gs^Ft, Gs^Ft, Gs, Gs^Ft, Gs^Ft, Gs^Ft, Gs^Ft, Gg^Efm, Gs^Ft, Gs^Ft, Gg, Gs^Ft, Gg^Ve, Gg, Gs^Ft, Gs^Ft
Gs^Ft, Gg, Gs^Ft, Gg^Vo, Gs^Ft, Gg, Gs^Ft, Gs^Ft, Gs^Ft, Gs, Gs, Gg, Gs^Ft, Gs^Ft, Gs^Ft, Gs^Ft, Gs^Ft, Gg, Gs^Ft, Gg, Gs^Ft, Gs^Ft, Gg, Gs^Ft, Gg, Ww, Ww, Ww, Ww, Gg, Gs^Ft, Gs^Ft, Gg, Gg^Efm, Gs^Ft, Gs^Ft, Gs^Ft, Gs^Ft, Gs, Gs, Gs^Ft, Gg^Efm, Gg^Efm, Gg, Gs^Ft, Gs^Ft, Gg, Gs^Ft, Gs, Gs^Ft
Gs^Ft, Gg, Gg, Gs^Ft, Gs^Ft, Gg, Gs^Ft, Gs^Ft, Gs^Ft, Gg, Gs^Ft, Gs^Ft, Gs^Ft, Gg, Gs^Ft, Gg, Gg, Gg, Gg, Gs^Ft, Gg, Gs^Ft, Gs^Ft, Gg, Gg, Gs^Ft, Ww, Wo, Ww, Gs^Ft, Gs^Ft, Gs^Ft, Gg^Ve, Gs^Ft, Gs^Ft, Gg, Gg, Gs^Ft, Gs^Ft, Gs, Gg, Gg, Gg, Gs^Ft, Gs^Ft, Gs^Ft, Gs^Ft, Gs^Ft, Gs, Gg
Gg, Gg, Gs^Ft, Gg, Gs^Ft, Gs, Gs, Gs^Ft, Gs^Ft, Gs^Ft, Gs^Ft, Gs^Ft, Gg, Gs^Ft, Gs^Ft, Gs^Ft, Gg, Gg, Gg, Gg, Gd^Xff, Gg, Gd^Xff, Gs^Ft, Gg, Ww, Wo, Wo, Ww, Gs, Gs^Ft, Gg, Gs^Efm, Gg, Gs^Ft, Gg, Gs^Ft, Gs^Ft, Gg, Gs^Ft, Gs^Ft, Gs^Ft, Gg, Gg, Gs^Ft, Gs, Gs^Ft, Gs^Ft, Gs^Ft, Gs^Ft
Gs^Ft, Gs^Ft, Gs^Ft, Gg, Gg, Gs, Gs^Ft, Gs^Ft, Gg, Gs^Ft, Gg^Vo, Gs^Ft, Gs^Ft, Gg, Gs^Ft, Gg, Gd^Xff, Gd^Xff, Re, Re, Re, Gg, Gs^Ft, Gd^Xff, Gs^Ft, Ww, Wo, Ww, Gs^Ft, Gs^Ft, Gs^Ft, Gg, Gs^Ft, Gs^Ft, Gs^Ft, Gg, Gs^Ft, Gg, Gs^Ft, Gs^Ft, Gg^Ve, Gs^Ft, Gs^Ft, Gs^Ft, Gs^Ft, Gs^Ft, Gg, Gs^Ft, Gs^Ft, Gg
Gg, Gs, Gg, Gg^Vo, Gg, Gs^Ft, Gg, Gg, Gs, Gs^Ft, Gg, Gg, Gs^Ft, Gg, Gs^Ft, Gs^Ft, Re, Gd^Xff, Co, Co, Co, Re, Gd^Xff, Gs^Ft, Ww, Ww, Ww, Ww, Gs, Gs, Gs^Ft, Gs^Ft, Gs^Ft, Gs, Gs, Gg, Gg^Efm, Gs^Ft, Gg, Gs^Ft, Gg, Gg, Cer, Cer, Cer, Gs, Gs^Ft, Gs^Ft, Gs, Gg
Gs^Ft, Gs^Ft, Gs^Ft, Gg, Gs^Ft, Gs^Ft, Gs^Ft, Gs^Ft, Gs, Gs^Ft, Gs^Ft, Gs^Ft, Gs^Ft, Gs^Ft, Gs^Ft, Gg, Re, Gs^Ft, Co, 5 Ko, Co, Re, Gg, Gg, Ww, Wo, Ww, Gs^Ft, Gs^Ft, Gs^Ft, Gs^Ft, Gg, Gs^Ft, Gs^Ft, Gs, Gs^Ft, Gg^Efm, Gs^Ft, Gg, Gs^Ft, Gs^Ft, Gs^Ft, Cer, 4 Ker, Cer, Gs, Gs^Ft, Gs, Gs^Ft, Gs^Ft
Gs^Ft, Gs, Gs, Gs^Ft, Gg, Gs^Ft, Gg, Gs^Ft, Gs^Ft, Gg, Gg, Gg, Gs^Ft, Gs^Ft, Gs^Ft, Gs^Ft, Gg, Re, Re, Co, Gs^Ft, Gs^Ft, Gg, Gg, Gd^Xff, Ww, Wwf, Gg^Efm, Gg^Efm, Gs^Ft, Gs^Ft, Gg^Ve, Gg, Gs^Ft, Gs^Ft, Gs^Ft, Gs, Gg^Efm, Gg, Gs^Ft, Gg^Ve, Gg, Gs^Ft, Cer, Gs^Ft, Gs^Ft, Gg^Ve, Gs^Ft, Gg, Gg
Gs^Ft, Gg, Gg, Gs^Ft, Gs^Ft, Gg, Gs^Ft, Gg, Gs^Ft, Gs^Ft, Gs^Ft, Gs^Ft, Gs^Ft, Gg^Vo, Gs^Ft, Gg, Gd^Xff, Gd^Xff, Gs^Ft, Gs^Ft, Gg, Gg, Gg, Gd^Xff, Ds, Wwf, Ww, Wwf, Gs^Ft, Gg^Efm, Gg, Gs^Ft, Gs^Ft, Gs^Ft, Gg, Gs, Gs, Gs^Ft, Gs^Ft, Gs^Ft, Gs^Ft, Gs^Ft, Gs^Ft, Gs^Ft, Gg, Gs^Ft, Gs^Ft, Gg, Gs, Gs^Ft
Gg, Gs^Ft, Gs^Ft, Gs^Ft, Gs^Ft, Gs^Ft, Gs^Ft, Gg, Gg, Gs^Ft, Gs^Ft, Gs^Ft, Gg, Gs^Ft, Gg, Gg, Gg, Gg, Gg, Gg, Gs^Ft, Gs^Ft, Gs^Ft, Ds, Ds, Wwf, Ww, Ww, Wwf, Gg^Efm, Gs^Ft, Gs^Ft, Gs, Gg, Gs^Ft, Gg, Gg, Gg, Gg^Efm, Gs^Ft, Gg, Gg^Efm, Gg, Gg, Gs^Ft, Gs^Ft, Gs, Gs^Ft, Gg, Gg
Gs^Ft, Gs, Gg, Gg, Gg, Gg^Vo, Gs^Ft, Gs, Gs, Gs^Ft, Gs^Ft, Gs^Ft, Wwf, Gg, Ww, Wwf, Ww, Wwf, Wwf, Gs^Ft, Ds, Gg^Vo, Ds, Ds, Ds, Ds, Ww, Wwf, Ww, Wwf, Ww, Gs, Gs, Gs^Ft, Gs^Ft, Gs^Ft, Gg, Gs^Ft, Gs^Ft, Gg^Efm, Gs^Ft, Gg, Gs^Ft, Gs^Ft, Gs^Ft, Gg, Gs^Ft, Gg, Gs, Gs^Ft
Gg, Gg, Gs^Ft, Gs^Ft, Gg, Gs^Ft, Gs^Ft, Gs^Ft, Gs, Gg, Wwf, Wwf, Ww, Ww, Wo, Ww, Wo, Ww, Ww, Ww, Ww, Ds, Ww, Ds, Ds, Ds, Ds, Ww, Wwf, Ww, Wwf, Gs^Ft, Gs^Ft, Gg, Gs^Ft, Gs^Ft, Gs^Ft, Gg^Efm, Gg^Efm, Gg^Efm, Gs^Ft, Gs^Ft, Gs^Ft, Gs^Ft, Gs, Gg, Gs^Ft, Gs^Ft, Gs, Gs
Gs, Gs, Gs, Gs^Ft, Gs^Ft, Gs^Ft, Gs^Ft, Gs^Ft, Gs^Ft, Gs^Ft, Ww, Ww, Wo, Wo, Wo, Wo, Wo, Wo, Ww, Wwf, Ww, Ww, Wo, Ww, Ds, Ds, Ds, Ds, Ww, Wwf, Gs^Ft, Gs^Ft, Gs^Ft, Gs, Gs, Gs^Ft, Gg, Gs^Ft, Gs^Ft, Gs^Ft, Gs^Ft, Gg^Efm, Gs^Ft, Gs, Gs, Gg, Gs^Ft, Gs^Ft, Gs^Ft, Gs^Ft
Gg, Gs, Gs^Ft, Gs^Ft, Gs, Gs, Gs^Ft, Gs^Ft, Gg, Wwf, Ww, Ww, Wo, Wo, Ds, Wo, Wo, Wo, Ww, Wwf, Ww, Wo, Ww, Ww, Wwf, Ds, Wwf, Ds, Ww, Wwf, Gs, Gs^Ft, Gs, Gs^Ft, Gs^Ft, Gs, Gs^Ft, Gg, Gg, Gs^Ft, Gg, Gs^Ft, Gg, Gg, Gs^Ft, Gs^Ft, Gs^Ft, Gg, Gg, Gg
Gs^Ft, Gg, Gs^Ft, Gs^Ft, Gs^Ft, Gs^Ft, Gs^Ft, Gg, Gs^Ft, Wwf, Wwf, Ww, Wo, Wo, Ds, Ds, Wo, Wo, Ww, Ww, Ww, Ww, Wwf, Ww, Wwf, Wwf, Ww, Ww, Ww, Ww, Gg^Efm, Gs, Gs^Ft, Gs^Ft, Gs^Ft, Gg, Gs^Ft, Gs^Ft, Gs^Ft, Gg, Gs^Ft, Gg^Efm, Gg^Efm, Gg^Efm, Gg^Efm, Gg, Gs^Ft, Gg, Gg, Gg
Gs^Ft, Gg, Gs^Ft, Gg, Gg, Gg, Gg, Gg, Gs^Ft, Gs^Ft, Wwf, Ww, Ww, Wo, Wo, Ww, Ww, Ww, Wwf, Wwf, Gg, Wwf, Gs^Ft, Wwf, Wwf, Ww, Wo, Wo, Ww, Gs, Gg^Efm, Gs^Ft, Gs^Ft, Gg, Gg^Efm, Gs^Ft, Gg^Efm, Gs^Ft, Gs^Ft, Gg, Gs^Ft, Gs^Ft, Gg, Gs^Ft, Gs^Ft, Gs^Ft, Gs^Ft, Gs^Ft, Gg, Gg
Gg, Gs^Ft, Gs^Ft, Gg, Gs^Ft, Gs^Ft, Gg, Gg, Gg^Efm, Gs^Ft, Gs^Ft, Ww, Ww, Ww, Ww, Ww, Gs^Ft, Gs^Ft, Gg, Gg^Efm, Gg^Efm, Gg, Gg, Gg, Gs^Ft, Ww, Wo, Ww, Gs, Gg, Gs^Ft, Gg^Efm, Gg, Gs^Ft, Gg^Efm, Gs^Ft, Gs^Ft, Gg^Efm, Gg^Sr, Gg^Ve, Gg, Gg, Gs^Ft, Gs^Ft, Gg^Efm, Gg^Efm, Gg, Gs^Ft, Gs^Ft, Gs^Ft
Gg, Gg, Gg, Gg, Gg^Efm, Gg, Gs^Ft, Gg^Efm, Gs^Ft, Gg, Gs^Ft, Wwf, Wwf, Wwf, Wwf, Wwf, Gs^Ft, Gg, Gg^Efm, Gs^Ft, Gs^Ft, Gg, Gs^Ft, Gs^Ft, Gg, Ww, Wo, Ww, Gs, Gs, Gs^Ft, Gs^Ft, Gg, Gs^Ft, Gg, Gg^Efm, Gg^Efm, Gg^Sr, Gg^Sc, Gg^Sr, Gg, Gg^Efm, Gs^Ft, Gs^Ft, Gg, Gg, Gs^Ft, Gg, Gg, Gg
Gg, Gs^Ft, Gg, Gs^Ft, Gg^Efm, Gs^Ft, Gs, Gs^Ft, Gs^Ft, Gs, Gd, Gd, Gs, Gs^Ft, Gs^Ft, Gg, Gg, Gg, Gg, Gg^Efm, Gg^Efm, Gg, Gg, Gs^Ft, Gg, Ww, Ww, Ww, Gs^Ft, Gg, Gg, Gs^Ft, Gs, Gs, Gg, Gs^Ft, Gg^Efm, Gg^Sr, Gg^Sr, Gg^Sr, Gg^Efm, Gs^Ft, Gg, Gg, Gs^Ft, Gs^Ft, Gs^Ft, Gg^Efm, Gg^Efm, Gg
Gg, Gg, Gs^Ft, Gg^Efm, Gg, Gs^Ft, Gg^Ve, Gs, Gg^Efm, Gs, Gs^Ft, Gs^Ft, Gs, Gd, Gs^Ft, Gg, Gg^Ve, Gg, Gs^Ft, Gg, Gs^Ft, Gs^Ft, Gg, Gs^Ft, Gs^Ft, Ww, Wo, Ww, Gs^Ft, Gs^Ft, Gg, Gg, Gg^Efm, Gs^Ft, Gs^Ft, Gs^Ft, Gs^Ft, Gs^Ft, Gs^Ft, Gg^Efm, Gg, Gg, Gg, Gg, Gg, Gg, Gg, Gs^Ft, Gs^Ft, Gs^Ft
Gg, Gs^Ft, Gg, Gg, Gs^Ft, Gs, Gs^Ft, Gd, Gg^Efm, Gs, Gs^Ft, Gs^Ft, Gd, Gd, Gs, Gs^Ft, Gg^Efm, Gg^Efm, Gg, Gg, Gg, Gg, Gg, Gg, Gg, Ww, Wo, Ww, Ww, Gs^Ft, Gs^Ft, Gg^Efm, Gg, Gg^Efm, Gs, Gs, Gg, Gg, Gg, Gg, Gs^Ft, Gg, Gs^Ft, Gg, Gg, Gg, Gg, Gg, Gs^Ft, Gg
Gs^Ft, Gg, Gs^Ft, Gs, Gd, Gs^Ft, Gs, Gd, Gs^Ft, Gd, Gs^Ft, Gd, Gs^Ft, Gs^Ft, Gg^Efm, Gg^Efm, Gg, Gg^Efm, Gs^Ft, Gg, Gg^Efm, Gs^Ft, Gg, Gs^Ft, Gg, Ww, Ww, Wo, Ww, Gs^Ft, Gs^Ft, Gg^Efm, Gs^Ft, Gs^Ft, Gg, Gg, Gg, Gs^Ft, Gs^Ft, Gs^Ft, Gs^Ft, Gs^Ft, Gs^Ft, Gs^Ft, Gg, Gs^Ft, Gs^Ft, Gg, Gg, Gg
Gg, Gs^Ft, Gg, Gs, Gd, Gd, Gs, Gs, Gd, Gs^Ft, Co, Co, Co, Gs^Ft, Gd, Gg^Efm, Gg, Gs^Ft, Gg, Gs^Ft, Gg^Efm, Gg^Efm, Gs^Ft, Gg, Gg, Gs^Ft, Ww, Wo, Ww, Gs^Ft, Gs, Gg, Gs^Ft, Gs^Ft, Gg, Gg, Gs, Gg, Gg^Efm, Gg, Gg^Efm, Gg, Gg, Gg, Gg, Gs^Ft, Gg, Gg, Gg, Gg
Gg, Gg, Gs^Ft, Gs^Ft, Gg, Gs^Ft, Gs^Ft, Gd, Gd, Gd, Co, 8 Ko, Co, Gd, Gd, Gs^Ft, Gg^Ve, Gg, Gs^Ft, Gg, Gg, Gg^Efm, Gg, Gs^Ft, Gg, Gs^Ft, Ww, Ww, Ww, Gs, Gs, Gs, Gs^Ft, Gg, Gg, Gg, Gs, Gs, Gs^Ft, Gg^Efm, Gg^Efm, Gg, Gs^Ft, Gg, Gs^Ft, Gs^Ft, Gg, Gg, Gg, Gg
Gg, Gg, Gg, Gs^Ft, Gg, Gg^Efm, Gs^Ft, Gs, Gs^Ft, Gs^Ft, Gg, Co, Gs^Ft, Gd, Gs^Ft, Gs^Ft, Gs^Ft, Gg, Gs^Ft, Gs^Ft, Gg, Gs^Ft, Gg, Gs^Ft, Gs^Ft, Gg, Ww, Wo, Ww, Gs^Ft, Gs^Ft, Gg, Gg, Gs^Ft, Gg, Gs^Ft, Gs^Ft, Gs^Ft, Gs^Ft, Gs, Gs, Gs^Ft, Gg, Gg, Gs^Ft, Gg, Gg, Gs^Ft, Gs^Ft, Gg
Gs^Ft, Gg, Gs^Ft, Gg, Gg, Gg^Efm, Gd, Gd, Gs^Ft, Gs^Ft, Gd, Gd, Gs^Ft, Gg, Gd, Gd, Gg^Efm, Gg^Efm, Gg, Gg, Gs^Ft, Gg, Gg^Efm, Gg^Efm, Gg^Efm, Gg, Ww, Wo, Wo, Ww, Gs^Ft, Gg, Gg, Gg, Gg, Gs^Ft, Gg, Gg, Gg, Gs, Gg, Gs^Ft, Gg, Gg, Gg, Gs^Ft, Gg, Gg, Gs^Ft, Gg
Gs^Ft, Gs^Ft, Gg^Efm, Gg, Gs^Ft, Gs^Ft, Gs, Gd, Gs^Ft, Gg, Gg^Efm, Gg^Efm, Gg, Gs^Ft, Gg, Gd, Gs^Ft, Gg^Efm, Gg^Efm, Gs^Ft, Gs^Ft, Gg, Gg, Gg, Gg, Gg, Gs^Ft, Ww, Ww, Ww, Gs^Ft, Gs^Ft, Gg, Gg, Gg, Gg, Gs^Ft, Gg, Gs^Ft, Gs^Ft, Gg, Gg, Gg, Gs, Gs^Ft, Gg, Gg, Gg^Efm, Gs^Ft, Gs^Ft
Gs^Ft, Gg^Efm, Gg, Gg, Gg^Ve, Gs^Ft, Gs, Gs^Ft, Gg, Gg, Gs^Ft, Gg^Efm, Gg, Gs, Gs, Gs^Ft, Gs^Ft, Gs^Ft, Gg, Gg^Efm, Gs^Ft, Gs^Ft, Gg, Gs^Ft, Gs^Ft, Gg, Gs^Ft, Ww, Wwf, Ww, Gg, Gg, Gs^Ft, Gg, Gg, Gs^Ft, Gs^Ft, Gg, Gg, Gs^Ft, Gg, Gs^Ft, Gs^Ft, Gs, Gs^Ft, Gs^Ft, Gg^Efm, Gg^Efm, Gg, Gs^Ft
Gg^Efm, Gg^Efm, Gs^Ft, Gg, Gg, Gg, Gs^Ft, Gg, Gg, Gs^Ft, Gg, Gs^Ft, Gg, Gs^Ft, Gs^Ft, Gg, Gg, Gg, Gg, Gg, Gg, Gs^Ft, Gg, Gs^Ft, Gg, Gg, Wwf, Wwf, Wwf, Wwf, Gg, Gs^Ft, Gs^Ft, Gg, Gs^Ft, Gs^Ft, Gg, Gg, Gg, Gg, Gg, Gg, Gs^Ft, Gs, Gg, Gg, Gs^Ft, Gg, Gg, Gg
Gg, Gg, Gs^Ft, Gg^Efm, Gg^Efm, Gg^Efm, Gg, Gs^Ft, Gg^Efm, Gg^Efm, Gg^Efm, Gg^Efm, Gg, Gg, Gg, Gg, Gs^Ft, Gg, Gs^Ft, Gs^Ft, Gs^Ft, Gg, Gs^Ft, Gs^Ft, Gg, Gs^Ft, Wwf, Wwf, Wwf, Wwf, Gg, Gs^Ft, Gg, Gg, Gg^Efm, Gg^Efm, Gg^Efm, Gs^Ft, Gs^Ft, Gs^Ft, Gg, Gg, Gg, Gg, Gg, Gg, Gs^Ft, Gs^Ft, Gs^Ft, Gg
Gg, Gs^Ft, Gs^Ft, Gs^Ft, Gg, Gg, Gs, Gg^Efm, Gg, Gs^Ft, Gs^Ft, Gg^Efm, Gs^Ft, Gs^Ft, Gg, Gs^Ft, Gg, Gg, Gs^Ft, Gs^Ft, Gg^Efm, Gs^Ft, Gg^Efm, Gs^Ft, Gg, Wwf, Wwf, Wwf, Wwf, Gg, Gg, Gs^Ft, Gg, Gg^Efm, Gg^Efm, Gg^Ve, Gg^Efm, Gg^Efm, Gs^Ft, Gs^Ft, Gg, Gg, Gs^Ft, Gg, Gs^Ft, Gs, Gs, Gs^Ft, Gg, Gg
Gg, Gg, Gg^Ve, Gg, Gs^Ft, Gs^Ft, Gs, Gs, Gs^Ft, Gg, Gs^Ft, Gs^Ft, Gg, Gg, Gs^Ft, Gg, Gg, Gg, Gg, Gg, Gg^Efm, Gg^Efm, Gg, Gg, Ww, Ww, Ww, Wwf, Gs^Ft, Gg, Gs^Ft, Gg, Gs^Ft, Gg, Gg, Gg^Efm, Gg, Gg, Gg, Gg, Gs^Ft, Gg, Gs^Ft, Gg, Gs^Ft, Gs^Ft, Gs, Gs^Ft, Gs^Ft, Gg
Gg, Gg, Gg^Efm, Gs^Ft, Gg^Sr, Gg^Sr, Gs^Sr, Gg, Gg, Gg, Gs^Ft, Gg, Gg, Gs^Ft, Gs^Ft, Gg, Gs^Ft, Gs^Ft, Gg, Gg, Gg, Gs^Ft, Gs^Ft, Gs^Ft, Ww, Wo, Ww, Gs^Ft, Gs^Ft, Gg, Gg, Gs^Ft, Gs, Gg, Gg, Gs^Ft, Gs^Ft, Gs^Ft, Gs^Ft, Gs, Gs, Gs^Ft, Gg, Gg, Gg, Gg, Gs^Ft, Gs^Ft, Gs^Ft, Gg
Gs^Ft, Gg^Efm, Gs^Ft, Gs^Ft, Gg^Sr, 7 Gg^Sc, Gg^Sr, Gs^Ft, Gs, Gs^Ft, Gg, Gg, Gg^Efm, Gg^Efm, Gs^Ft, Gg, Gg, Gs^Ft, Gg, Gs^Ft, Gg, Gs^Ft, Gg, Gs^Ft, Ww, Wo, Ww, Gg, Gs^Ft, Gs^Ft, Gg, Gs, Gs, Gs, Gs^Ft, Gs, Gs, Gg, Gg, Gs, Gg, Gg, Gg, Gg, Gg, Gs^Ft, Gg, Gs^Ft, Gg, Gg
Gs^Ft, Gg^Efm, Gg^Efm, Gs^Ft, Gg, Gs^Sr, Gg, Gs, Gs, Gg, Gg, Gs^Ft, Gs^Ft, Gs^Ft, Gg, Gg, Gg, Gg^Ve, Gg, Gs^Ft, Gs^Ft, Gg, Gs^Ft, Gg, Ww, Wo, Ww, Gg, Gg, Gs^Ft, 1 Gs, Gs, Gg, Gs^Ft, Gs, Gs^Ft, Gs, Gs, Gg^Emf, Gg^Emf, Gg^Emf, Gs^Ft, Gg, Gg, Gs^Ft, Gg, Gg, Gg, Gs^Ft, Gg
Gs^Ft, Gs^Ft, Gs^Ft, Gg^Efm, Gg, Gg^Ve, Gs^Ft, Gs^Ft, Gg, Gs^Ft, Gs^Ft, Gg, Gg^Efm, Gg^Efm, Gg, Gs^Ft, Gs^Ft, Gs^Ft, Gg, Gg, Gs^Ft, Gg, Gs^Ft, Gg, Gg, Ww, Wo, Ww, Gs^Ft, Gg, Gg, Gs, Gg, Gg, Gg, Gs, Gs^Ft, Gs^Ft, Gs^Ft, Gg^Emf, Gs^Ft, Gg, Gg, Gg, Gs^Ft, Gs^Ft, Gg, Gs^Ft, Gs^Ft, Gg
Gg, Gs^Ft, Gg, Gs^Ft, Gg, Gg, Gg, Gg, Gg, Gg, Gg, Gg^Efm, Gg, Gg, Gg, Gs^Ft, Gg, Gg, Gg, Gs^Ft, Gg, Gg, Gg, Gs^Ft, Gg, Ww, Ww, Ww, Wo, Gs^Ft, Gg, Gg, Gg, Gg, Gg, Gg, Gg, Gg, Gs^Ft, Gs^Ft, Gs^Ft, Gg, Gg, Gs^Ft, Gg, Gg, Gg, Gs^Ft, Gg, Gg
