border_size=1
usage=map

Qxu, Qxu, Qxu, Qxu, Qxu, Qxu, Qxu, Qxu, Qxu, Qxu, Qxu, Qxu, Qxu, Uu, Ur, Ur, Ur, Uh, Qxu, Qxu, Qxu, Qxu, Qxu, Qxu, Qxu, Xu, Xu, Xu, Xu, Xu, Xu, Xu, Xu, Xu, Xu, Xu, Xu, Xu, Xu, Xu, Qxu, Qxu, Qxu, Qxu, Qxu, Qxu
Qxu, Qxu, Qxu, Qxu, Qxu, Qxu, Qxu, Qxu, Qxu, Qxu, Uu, Qxu, Uu^Uf, Uu^Uf, Uu, Ur, Uu, Uh, Uu, Qxu, Qxu, Qxu, Qxu, Qxu, Qxu, Xu, Xu, Xu, Xu, Xu, Xu, Xu, Xu, Xu, Xu, Xu, Xu, Xu, Xu, Xu, Xu, Qxu, Qxu, Qxu, Qxu, Qxu
Qxu, Qxu, Qxu, Qxu, Qxu, Qxu, Uu^Uf, Qxu, Ur, Uu, Uu, Uh, Uh, Uh, Uu^Uf, Uu, Uu, Uh, Uh, Qxu, Qxu, Qxu, Qxu, Qxu, Qxu, Xu, Xu, Xu, Xu, Xu, Xu, Xu, Xu, Xu, Xu, Xu, Uu, Xu, Ur, Xu, Xu, Qxu, Qxu, Qxu, Qxu, Qxu
Qxu, Qxu, Qxu, Qxu, Cud, Uu, Urb, Uh, Uh, Uh, Uu, Uu^Vu, Uu, Ur, Uu, Uu^Uf, Ur, Uu, Ur, Qxu, Qxu, Qxu, Qxu, Qxu, Qxu, Qxu, Xu, Xu, Xu, Xu, Xu, Xu, Xu, Xu, Uh, Uh, Uu, Uu, Urb, Ur, Uh, Uh, Uh, Qxu, Qxu, Qxu
Qxu, Qxu, Qxu, Cud, 3 Kud, Cud, Urb, Uh, Uu, Uu^Uf, Uu^Uf, Urb, Uu, Uu, Uh, Uu, Uu^Vu, Ur, Uu, Uu, Qxu, Qxu, Qxu, Qxu, Qxu, Qxu, Qxu, Xu, Xu, Xu, Xu, Xu, Xu, Xu, Uu, Uh, Uu, Uu^Vu, Co, Co, Ur, Ur, Uu, Qxu, Qxu, Qxu
Qxu, Qxu, Qxu, Cud, Cud, Cud, Urb, Urb, Uh, Uu, Urb, Urb, Uu^Uf, Uu, Uh, Uu, Urb, Urb, Xu, Xu, Xu, Xu, Xu, Qxu, Qxu, Qxu, Qxu, Qxu, Xu, Xu, Xu, Xu, Xu, Uu, Uu^Uf, Uu, Ur, Uu, Uu, 6 Ko, Co, Uu, Ur, Qxu, Qxu, Qxu
Qxu, Qxu, Qxu, Qxu, Qxu, Urb, Uu, Ur, Uu^Vu, Uu, Uu, Uu, Uu, Uu^Uf, Ur, Uh, Uu, Uu, Xu, Xu, Xu, Xu, Xu, Qxu, Qxu, Qxu, Qxu, Qxu, Qxu, Xu, Xu, Xu, Xu, Uu, Uu^Uf, Uu^Uf, Uu, Ur, Uu, Co, Uu, Uu^Vu, Ur, Xu, Qxu, Qxu
Xu, Qxu, Qxu, Qxu, Uu, Uu, Uu, Ur, Uh, Uh, Uu, Uu, Xu, Urb, Ur, Uu, Uu, Xu, Xu, Xu, Xu, Xu, Uu, Urb, Uu, Qxu, Xu, Qxu, Qxu, Qxu, Uh, Xu, Xu, Xu, Uu, Uu, Uu^Uf, Ur, Uu, Ur, Ur, Uu, Xu, Xu, Qxu, Qxu
Xu, Xu, Xu, Xu, Xu, Uu, Xu, Uu, Uu, Uh, Ur, Uu, Xu, Xu, Uh, Ur, Urb, Urb, Uu, Xu, Xu, Xu, Uh, Cud^Ii, Uu, Xu, Xu, Qxu, Qxu, Uh, Uu, Uu, Urb, Urb, Uu, Uu, Uu^Uf, Uu, Qxu, Qxu, Qxu, Xu, Qxu, Qxu, Qxu, Qxu
Xu, Xu, Xu, Xu, Xu, Xu, Xu, Xu, Uu, Uu, Uu, Ur, Xu, Xu, Xu, Uh, Uu, Uu, Ur, Xu, Xu, Xu, Xu, Uu, Xu, Xu, Ur, Uu, Uu, Uh, Ur, Ur, Uu, Uu, Uu, Uu^Uf, Xu, Xuc, Xuc, Qxu, Qxu, Qxu, Qxu, Qxu, Qxu, Qxu
Xu, Xu, Xu, Xu, Xu, Xu, Xu, Xu, Uu, Uu, Uh, Uu, Uu, Xu, Xu, Uh, Uh, Uu^Ufi, Uu, Ur, Uu, Uu, Xu, Xu, Uu^Vu, Xu, Ur, Uu, Ur, Uu, Uh, Ur, Uu, Urb, Uh, Uh, Xu, Xu, Qxu, Qxu, Qxu, Qxu, Xu, Xu, Xu, Xu
Xu, Xu, Xu, Xu, Qxu, Qxu, Qxu, Uu, Urb, Uh, Uu, Uh, Uu, Xu, Xu, Xu, Xu, Uu^Ufi, Uu, Ur, Uu^Ufi, Uu, Uu, Xu, Uu^Uf, Ur, Uu, Uu, Uu, Uh, Uh, Uu, Uu, Uu, Uu, Uh, Xu, Xu, Qxu, Qxu, Xu, Qxu, Xu, Xu, Xu, Xu
Xu, Xu, Xu, Qxu, Qxu, Qxu, Qxu, Qxu, Urb, Uu^Uf, Uu^Uf, Uu, Uu, Uh, Xu, Xu, Qxu, Uu, Urb, Uu, Uu, Uh, Uu, Urb, Uu, Uu, Uh, Ur, Uu^Uf, Uu^Uf, Uu^Uf, Ur, Ur, Uu, Ur, Ur, Qxu, Qxu, Qxu, Qxu, Xu, Xu, Xu, Xu, Xu, Xu
Xu, Xu, Xu, Qxu, Qxu, Qxu, Qxu, Qxu, Uu, Uu^Uf, Uu, Urb, Uu, Uh, Uu, Qxu, Qxu, Qxu, Uu^Uf, Uu^Vu, Uu, Ur, Ur, Uu, Uu, Uh, Uh, Uu, Uu, Ur, Uu, Uu, Urb, Ur, Uu, Ur, Qxu^Bh\, Qxu, Qxu, Xu, Xu, Xu, Xu, Xu, Xu, Xu
Xu, Xu, Xu, Xu, Qxu, Qxu, Qxu, Uh, Uu, Uu, Uu, Uh, Uu, Uu, Uu, Qxu, Qxu, Qxu, Qxu, Uu, Qxu, Ur, Uu^Uf, Uu, Urb, Uu, Uu, Urb, Ur, Ur, Xu, Urb, Ur, Urb, Uu, Qxu, Qxu, Qxu^Bh\, Uu, Uu, Xu, Xu, Xu, Xu, Xu, Xu
Xu, Xu, Xu, Xu, Qxu, Qxu, Qxu, Uh, Uh, Uu, Ur, Uu, Ur, Uu, Qxu, Qxu, Qxu, Qxu, Qxu, Qxu, Qxu, Qxu, Xu, Uu^Uf, Uh, Urb, Uu, Urb, Uu, Uu, Xu, Xu, Ur, Uu^Vu, Uu, Xu, Qxu, Qxu, Uu, Uh, Uh, Xu, Xu, Xu, Xu, Xu
Xu, Xu, Xu, Xu, Xu, Qxu, Uu^Vu, Uu^Ufi, Cud, Cud, Cud, Ur, Uu, Xu, Xu, Qxu, Qxu, Qxu, Qxu, Qxu, Qxu, Xu, Xu, Ur, Ur, Uh, Uu, Uu, Ur, Qxu, Qxu, Xu, Xu, Ur, Xu, Xu, Xu, Uu, Uu, Uu^Vu, Ur, Xu, Xu, Xu, Xu, Xu
Xu, Xu, Xu, Xu, Xu, Ur, Uu, Uu, Cud, 2 Kud, Cud, Uu, Uu, Xu, Xu, Qxu, Qxu, Qxu, Qxu, Qxu, Xu, Xu, Uu, Uu, Uu, Uu, Uu^Uf, Ur, Qxu, Qxu, Qxu, Xu, Xu, Xu, Xu, Xu, Uu^Uf, Uu^Uf, Uu, Ur, Uu, Xu, Xu, Xu, Xu, Xu
Xu, Xu, Xu, Xu, Xu, Ur, Ur, Uu, Uu, Cud, Uu, Uh, Uh, Uu, Xu, Xu, Xu, Xu, Xu, Qxu, Xu, Xu, Uh, Uu, Uu, Uu, Uh, Uh, Qxu, Qxu, Qxu, Qxu, Xu, Xu, Xu, Xu, Uu^Uf, Uu^Ii, Uh, Uu, Xu, Xu, Xu, Xu, Xu, Xu
Xu, Xu, Xu, Xu, Xu, Xu, Uu^Ufi, Uu, Uh, Ur, Uu^Vu, Uh, Uu, Ur, Ur, Xu, Xu, Xu, Xu, Xu, Xu, Xu, Xu, Uh, Uu^Uf, Uu, Ur, Uh, Qxu, Qxu, Qxu, Qxu, Xu, Xu, Xu, Xu, Xu, Uu, Uh, Uh, Xu, Xu, Xu, Xu, Mm^Xm, Mm^Xm
Xu, Xu, Mm^Xm, Xu, Xu, Xu, Xu, Uu^Ufi, Uh, Uh, Ur, Uu, Uh, Uu, Uu^Ufi, Uu^Ufi, Uu, Uu, Ur, Xu, Xu, Xu, Xu, Uh, Uu, Ur, Ur, Qxu, Qxu, Qxu, Qxu, Xu, Xu, Xu, Xu, Xu, Xu, Xu, Xu, Xu, Xu, Xu, Mm^Xm, Mm^Xm, Mm, Mm
Mm^Xm, Mm^Xm, Mm, Mm^Xm, Mm^Xm, Xu, Xu, Xu, Uu, Uh, Uu, Uu, Xu, Uu, Uh, Uh, Uh, Uu^Ii, Ur, Xu, Xu, Xu, Ur, Uu, Uu, Uu, Xu, Qxu, Xu, Qxu, Xu, Xu, Xu, Xu, Mm^Xm, Xu, Xu, Xu, Xu, Xu, Mm^Xm, Mm^Xm, Mm, Mm^Xm, Mm^Xm, Mm
Mm, Mm, Mm, Mm, Mm^Xm, Mm^Xm, Xu, Xu, Xu, Uu, Xu, Xu, Xu, Xu, Xu, Xu, Xu, Uu, Xu, Xu, Xu, Xu, Ur, Uu, Ur, Xu, Xu, Xu, Xu, Xu, Xu, Xu, Mm^Xm, Mm^Xm, Mm, Mm^Xm, Mm^Xm, Xu, Mm^Xm, Mm^Xm, Mm^Xm, Mm^Xm, Mm^Xm, Mm, Mm, Mm
Mm, Mm^Xm, Mm^Xm, Mm, Mm, Mm^Xm, Mm^Xm, Xu, Xu, Xu, Xu, Xu, Xu, Xu, Xu, Xu, Xu, Xu, Xu, Xu, Xu, Xu, Xu, Uu, Uh, Xu, Xu, Xu, Mm^Xm, Mm^Xm, Mm^Xm, Mm^Xm, Mm, Mm, Mm, Mm, Mm, Mm^Xm, Mm^Xm, Mm^Xm, Mm, Mm, Mm, Mm^Xm, Mm^Xm, Mm
Mm, Mm, Mm, Mm^Xm, Mm, Mm, Mm, Mm^Xm, Mm^Xm, Xu, Mm^Xm, Mm^Xm, Mm^Xm, Xu, Mm^Xm, Xu, Xu, Xu, Mm^Xm, Xu, Xu, Xu, Uh, Uh, Uh, Uh, Mm^Xm, Mm^Xm, Mm, Mm, Mm, Mm^Xm, Mm, Mm, Mm, Mm, Mm, Mm, Mm, Mm^Xm, Mm, Mm, Mm, Mm, Mm, Mm
Mm, Mm, Mm^Xm, Mm, Mm, Mm, Mm, Mm, Mm, Mm^Xm, Mm, Mm, Mm, Mm^Xm, Mm, Mm^Xm, Mm^Xm, Mm^Xm, Mm, Mm^Xm, Mm^Xm, Xu, Gs, Gs, Gs, Hh, Mm, Mm, Mm, Mm, Mm, Mm, Mm, Mm, Mm, Mm, Mm^Xm, Mm^Xm, Mm, Mm, Mm, Mm, Mm, Mm, Hh, Hh
Mm, Mm, Mm, Mm^Xm, Mm^Xm, Mm, Hh, Mm, Mm, Mm^Xm, Mm^Xm, Mm, Mm, Mm, Mm, Mm, Mm, Mm^Xm, Mm^Xm, Mm, Mm, Mm^Xm, Gs^Fms, Gs^Fms, Gg, Hh, Hh, Mm, Hh, Hh, Hh, Hh, Hh, Hh, Mm^Xm, Mm^Xm, Mm, Mm, Mm, Mm, Mm, Mm^Xm, Mm, Mm, Hh, Hh
Hh, Hh, Hh, Mm, Mm, Mm, Hh, Hh, Hh, Mm, Mm, Mm^Xm, Mm^Xm, Mm, Mm, Mm, Mm, Mm, Mm, Mm, Hh, Mm, Hh, Gs^Fms, Gs^Fms, Gs^Fms, Hh, Hh, Hh, Hh, Hh, Hh, Mm^Xm, Mm^Xm, Mm, Mm, Co, Co, Co, Hh, Mm, Mm, Mm, Mm, Hh, Hh
Hh, Hh, Hh, Mm, Mm, Mm, Mm, Hh, Hh, Hh, Mm, Mm, Mm, Mm, Hh, Hh, Mm, Mm^Xm, Mm, Hh, Hh, Hh, Hh, Gg, Gs, Gs^Fms, Gs, Hh, Hh, Hh, Mm, Mm^Xm, Mm, Mm, Mm, Mm, Co, 4 Ko, Co, Hh, Mm, Mm, Mm, Hh, Hh, Gg
Hh, Hh, Hh, Hh, Mm, Mm, Mm, Hh, Hh, Hh, Hh, Mm, Mm, Mm, Hh, Hh, Hh, Mm, Mm, Hh, Hh, Hh, Gs^Fms, Gs^Fms, Gs^Fms, Gs, Hh, Hh, Hh, Hh, Hh, Mm, Hh, Mm, Hh, Hh, Hh, Co, Mm, Mm, Mm, Mm, Hh, Hh, Gs^Fms, Gs^Fms
Hh, Hh, Hh, Hh, Mm, Mm, Mm, Mm, Hh, Hh, Hh, Hh, Hh, Hh, Hh, Hh, Hh, Hh, Hh, Hh, Hh, Gs^Fms, Gs^Fms, Gs^Fms, Gs^Fms, Gs^Fms, Gs^Fms, Hh, Hh, Hh, Hh, Hh, Hh, Hh, Hh, Hh, Mm, Mm, Mm, Mm, Mm, Hh, Gs^Fms, Gs, Gs^Fms, Gs^Fms
Hh, Hh, Hh, Hh, Hh, Hh, Hh, Hh, Hh, Hh, Gs, Hh, Gs^Fms, Hh, Gs^Fms, Gs^Fms, Gg, Gs^Fms, Gg, Hh, Gs^Fms, Gs^Fms, Gs^Fms, Gs, Gs, Gs^Fms, Gs, Gs^Fms, Gs, Hh, Gs, Hh, Hh, Hh, Hh, Hh, Hh, Mm, Hh, Mm, Hh, Hh, Gs^Fms, Gs^Fms, Gs, Gg
Gs, Hh, Gs^Fms, Hh, Hh, Hh, Hh, Hh, Co, Gs^Fms, Gs, Gs^Fms, Gs^Fms, Gs^Fms, Gs^Fms, Gs^Fms, Gs, Gs, Gs^Fms, Gg, Gg, Gs, Gs^Fms, Gg, Gg, Gg, Gg, Gs^Fms, Gs^Fms, Gs^Fms, Gs^Fms, Gs^Fms, Gs^Fms, Gs^Fms, Gg, Hh, Gs, Hh, Hh, Hh, Gs^Fms, Gd^Vo, Gs^Fms, Gs^Fms, Gs, Gs^Fms
Gs^Fms, Gs^Fms, Gd^Vo, Gs^Fms, Gs^Fms, Hh, Gg, Co, 5 Ko, Co, Gs^Fms, Gs^Fms, Gg, Gs^Fms, Gs^Fms, Gs^Fms, Gs^Fms, Gs^Fms, Gg, Gg, Gs, Gs, Gs^Fms, Gd^Vo, Gs^Fms, Gs^Fms, Gg, Gs, Gs^Fms, Gs^Fms, Gs^Fms, Gs^Fms, Gs^Fms, Gg, Gg, Gs^Fms, Gs, Gs, Gg, Gg, Gg, Gs^Fms, Gs^Fms, Gs, Gg, Gg
Gg, Gs^Fms, Gs, Gs, Gg, Gg, Gs^Fms, Co, Co, Co, Gg, Gg, Gg, Gs, Gs, Gs^Fms, Gd^Vo, Gg, Gs^Fms, Gs^Fms, Gs^Fms, Gs, Gg, Gs^Fms, Gs^Fms, Gg, Gg, Gs, Gs, Gs, Gs^Fms, Gs, Gs, Gg, Gg, Gg, Gg, Gg, Gs, Gs, Gs, Gg, Gg, Gs^Fms, Gg, Gs^Fms
Gs^Fms, Gg, Gg, Gs, Gg, Gg, Gs^Fms, Gg, Gs^Fms, Gg, Gs^Fms, Gs^Fms, Gs^Fms, Gs^Fms, Gs, Gs^Fms, Gs^Fms, Gs^Fms, Gs^Fms, Gg, Gs^Fms, Gg, Gs^Fms, Gg, Gs^Fms, Gs, Gg, Gg, Gg, Gs^Fms, Gg, Gs, Gs^Fms, Gs^Fms, Gs^Fms, Gs^Fms, Gs, Gs^Fms, Gs^Fms, Gs, Gs, Gs^Fms, Gg, Gs^Fms, Gs^Fms, Gs^Fms
Gs^Fms, Gg, Gg, Gs^Fms, Gs, Gs, Gs^Fms, Gg, Gg, Gg, Gs, Gs, Gs^Fms, Gs^Fms, Gs^Fms, Gs^Fms, Gs^Fms, Gg, Gs^Fms, Gs, Gs, Gs, Gs, Gs^Fms, Gs^Fms, Gs, Gg, Gs, Gs, Gg, Gs, Gg, Gg, Gs^Fms, Gs^Fms, Gs, Gs^Fms, Gs^Fms, Gs^Fms, Gs, Gs, Gs^Fms, Gg, Gg, Gs, Gg
Gs^Fms, Gg, Gg, Gg, Gg, Gs^Fms, Gs^Fms, Gs^Fms, Gs^Fms, Gs^Fms, Gs, Gs, Gs, Gs, Gg, Gs^Fms, Gg, Gs^Fms, Gs^Fms, Gs^Fms, Gs^Fms, Gs^Fms, Gs^Fms, Gs^Fms, Gs^Fms, Gg, Gs^Fms, Gs^Fms, Gs^Fms, Gs^Fms, Gg, Gs, Gs^Fms, Gg, Gs^Fms, Gs^Fms, Gg, Gg, Gs^Fms, Gg, Gg, Gg, Gs^Fms, Gs^Fms, Gs, Gs
Gg, Gg, Gs^Fms, Gs, Gs, Gg, Gs^Fms, Gs^Fms, Gg, Gs, Gs, Gs, Gg, Gs, Gs^Fms, Gg, Gs^Fms, Gs^Fms, Gs^Fms, Gs^Fms, Gg, Gg, Gg, Gs^Fms, Gs^Fms, Gg, Gs^Fms, Gs, Gs, Gs^Fms, Gs^Fms, Gs, Gs, Gs, Gg, Gs^Fms, Gg, Gs^Fms, Gs^Fms, Gs, Gs^Fms, Gs^Fms, Gg, Gs^Fms, Gs^Fms, Gs^Fms
Gg, Gg, Gs, Gs^Fms, Gs^Fms, Gs^Fms, Gg, Gg, Gs^Fms, Gg, Gg, Gs, Gs^Fms, Gs^Fms, Gs, Gg, Gs^Fms, Gs^Fms, Gs^Fms, Gg, Gg, Gs^Fms, Gg, Gg, Gg, Gg, Gg, Gs, Gs, Gg, Gg, Gg, Gg, Gs^Fms, Gs^Fms, Gg, Gs^Fms, Gd^Vo, Gs^Fms, Gs, Gs^Fms, Gs^Fms, Gg, Gg, Gg, Gg
Gs^Fms, Gg, Gs, Gs^Fms, Gs, Gs^Fms, Gg, Gg, Gg, Gg, Gs, Gs^Fms, Gs^Fms, Gs, Gs^Fms, Gg, Gs^Fms, Gs^Fms, Gs^Fms, Gg, Gg, Gg, Gs^Fms, Gg, Gs, Gs^Fms, Gs, Gg, Gg, Gs^Fms, Gg, Gs^Fms, Gg, Gs^Fms, Gg, Gg, Gs, Gs^Fms, Gg, Gs^Fms, Gg, Gg, Gs^Fms, Gs^Fms, Gg, Gg
Gs^Fms, Gg, Gg, Gg, Gg, Gg, Gs^Fms, Gs^Fms, Gs^Fms, Gd^Vo, Gs^Fms, Gs, Gs^Fms, Gs, Gs^Fms, Gg, Gg, Gs, Gs, Gs^Fms, Gg, Gg, Gs^Fms, Gs^Fms, Gg, Gs, Gs^Fms, Gg, Gs^Fms, Gs, Gs^Fms, Gg, Gs^Fms, Gs^Fms, Gs^Fms, Gg, Gg, Gs, Gg, Gs^Fms, Gs^Fms, Gg, Gs, Gg, Gs, Gg
Gs, Gs, Gs^Fms, Gg, Gs^Fms, Gs^Fms, Gg, Gs, Gs, Gs^Fms, Gg, Gg, Gg, Gg, Gs, Gg, Gg, Gs^Fms, Gg, Gg, Gg, Gg, Gs^Fms, Gd^Vo, Gs, Gs^Fms, Gg, Gg, Gg, Gs, Gs, Gg, Gg, Gg, Gg, Gs, Gs^Fms, Gs, Gs^Fms, Gs^Fms, Gs^Fms, Gg, Gg, Gs, Gg, Gg
Gs, Gs^Fms, Gg, Gg, Gs, Gg, Gs^Fms, Gs^Fms, Gs^Fms, Gs, Gg, Gg, Gs^Fms, Gs, Gs, Gs, Gg, Gg, Gs^Fms, Gs, Gs^Fms, Gg, Gg, Gs^Fms, Gs, Gs^Fms, Gg, Gg, Gs^Fms, Gg, Gg, Gg, Gd^Vo, Gs^Fms, Gs^Fms, Gs, Gs^Fms, Gg, Gg, Gg, Gg, Gg, Gs, Gs, Gs, Gg
Gg, Gs, Gg, Gg, Gs^Fms, Gs, Gs^Fms, Gs^Fms, Gs, Gs^Fms, Gs^Fms, Gs^Fms, Gs^Fms, Gg, Gg, Gg, Gs^Fms, Gg, Gg, Gs, Gs, Gs^Fms, Gg, Gg, Gg, Gg, Gs, Gs^Fms, Gs, Gs^Fms, Gs, Gs^Fms, Gs^Fms, Gs^Fms, Gs, Gs, Gs^Fms, Gg, Gg, Gg^Ecf, Gg, Gg, Gg, Gs, Gg, Gg
Gg, Gg, Gs, Gg, Gg, Gs, Gg, Gs^Fms, Gs, Gs^Fms, Gs, Gs^Fms, Gd^Vo, Gs^Fms, Gg, Gs^Fms, Gs^Fms, Gs^Fms, Gs^Fms, Gs^Fms, Gs^Fms, Gg, Gg, Gs^Fms, Gs^Fms, Gs, Gs^Fms, Gs^Fms, Gs, Gs^Fms, Gs, Gs, Gs^Fms, Gg, Gs^Fms, Gs^Fms, Gs, Gg, Re^Vct, Re^Vct, Re^Sr, Re^Vct, Gg, Gs^Ecf, Gg, Gg
Gg, Gg, Gs, Gg, Gg, Gg, Gs, Gg, Gg, Gs, Gs^Fms, Gs^Fms, Gs^Fms, Gs, Gg, Gg, Gg, Gs, Gs, Gs, Gs^Fms, Gg, Gs, Gs, Gs^Fms, Gs, Gs^Fms, Gs, Gg, Gg, Gg, Gs, Gs^Fms, Gg, Gg, Gs, Gs, Gs, Gs, Re^Sr, 1 Re^Sc, Re^Sr, Gg, Gg, Gg, Gg
Gg, Gs, Gs, Gs, Gs, Gg, Gs, Gg, Gg, Gs^Fms, Gs, Gs, Gg, Gg, Gs, Gs, Gs, Gg, Gs, Gg, Gs^Fms, Gg, Gg, Gs, Gs, Gs^Fms, Gs^Fms, Gg, Gs^Fms, Gg, Gs, Gs, Gs, Gg, Gg, Gg, Gs, Gs, Re^Vct, Re^Sr, Re^Sr, Re^Sr, Gg, Gg, Gs, Gg
Gg, Gs, Gg, Gg, Gs, Gs, Gs, Gs, Gg, Gg, Gg, Gg, Gs, Gg, Gs, Gs, Gs, Gg, Gg, Gs^Fms, Gg, Gg, Gg, Gg, Gg, Gs^Fms, Gg, Gs^Fms, Gg, Gg, Gg, Gs, Gs, Gs, Gs, Gs, Gs, Gg, Gg, Gg, Gg, Re^Vct, Gg, Gg, Gs, Gg
Gg, Gg, Gs, Gs, Gg, Gg, Gg, Gs, Gg, Gg, Gg, Gg, Gg, Gs, Gg, Gg, Gg, Gg, Gg, Gg, Gg, Gg, Gg, Gg, Gg, Gg, Gg, Gg, Gg, Gg, Gg, Gs, Gg, Gg, Gg, Gg, Gs^Fms, Gg, Gs^Fms, Gg, Gg, Gg, Gs, Gs, Gg, Gg
