Xu, Xu, Xu, Xu, Xu, Xu, Xu, Xu, Xu, Xu, Xu, Uh, Uu, Uu, Uu, Uh, Xu, Xu, Xu, Xu, Xu, Xu, Xu, Xu, Xu, Xu, Xu, Xu, Xu, Xu, Xu, Xu, Xu, Uu, Uu, Xu, Xu, Xu, Xu, Xu, Xu, Xu, Xu, Uh, Uu, Uu
Xu, Xu, Xu, Xu, Xu, Xu, Xu, Xu, Xu, Xu, Xu, Uh, Uh, Tb^Tf, Uu, Uh, Uh, Xu, Xu, Xu, Xu, Xu, Xu, Xu, Xu, Xu, Xu, Xu, Xu, Xu, Xu, Xu, Rb, Rb, Tb^Tf, Xu, Xu, Xu, Xu, Xu, Xu, Xu, Uh, Uh, Ur, Ur
Xu, Xu, Xu, Xu, Xu, Xu, Xu, Xu, Xu, Xu, Xu, Xu, Xu, Tb^Tf, Rb^Es, Uu^Es, Uh^Es, Xu, Xu, Xu, Xu, Xu, Xu, Xu, Xu, Xu, Uh, Tb^Tf, Ur, Xu, Xu, Xu, Uh^Es, Tb^Tf, Xu, Xu, Xu, Xu, Tb^Tf, Xu, Xu, Xu, Urb, Urb, Tb^Tf, Uu
Xu, Xu, Xu, Xu, Xu, Xu, Qxu, Qxu, Xu, Xu, Xu, Xu, Xu, Uu, Ur, Uu^Vu, Uu, Xu, Xu, Xu, Xu, Xu, Xu, Xu, Tb^Tf, Ur, Ur, Tb^Tf, Ur, Uh, Xu, Xu, Tb^Tf, Uh^Es, Xu, Xu, Xu, Tb^Tf, Co, Uu, Uu, Uh, Co, Uh, Tb^Tf, Uh
Xu, Xu, Xu, Xu, Xu, Xu, Qxu, Qxu, Qxu, Xu, Qxu, Xu, Xu, Xu, Xu, Ur, Uu, Ur, Tb^Tf, Tb^Tf, Ur, Xu, Xu, Xu, Uu, Tb^Tf, Qxu, Qxu, Uu, Rb, Uu^Es, Uu^Es, Tb^Tf, Rb^Es, Xu, Xu, Uu, Tb^Tf, Co, Co, Co, Uh, Urb, Urb, Uh, Uh
Xu, Xu, Uu, Xu, Xu, Qxu, Qxu, Qxu, Qxu, Qxu, Qxu, Qxu, Xu, Xu, Xu, Uh, Uu, Tb^Tf, Tb^Tf, Uu, Ur, Xu, Xu, Xu, Uu, Ur, Qxu, Qxu, Qxu, Rb, Tb^Tf, Uu^Vu, Uu^Es, Xu, Xu, Xu, Ur, Co, Co, 2 Ko, Co, Uu, Xu, Xu, Xu, Xu
Urb, Uu, Uh, Tb^Tf, Tb^Tf, Qxu, Qxu, Qxu, Uh, Uh, Uu^Vu, Tb^Tf, Tb^Tf, Xu, Xu, Xu, Ur, Ur, Uh^Es, Uh^Es, Uu^Es, Uu^Es, Uu^Es, Uu, Tb^Tf, Tb^Tf, Qxu, Qxu, Qxu, Qxu, Tb^Tf, Ur, Uu^Es, Xu, Uu, Ur, Uh, Uu, Uu, Uu, Uu, Uu, Xu, Xu, Xu, Xu
Ur, Urb, Uh, Uu^Vu, Urb^Edt, Uu, Tb^Tf, Tb^Tf, Urb, Uh, Uh^Edt, Tb^Tf, Uu, Xu, Xu, Xu, Uu, Uu, Uu^Vu, Uh^Es, Rb, Uu^Es, Uh, Uu, Qxu, Qxu, Qxu, Qxu, Qxu, Qxu, Qxu, Rb^Es, Uh, Uh, Uu^Es, Uh, Tb^Tf, Uu, Xu, Xu, Xu, Xu, Xu, Xu, Xu, Xu
Uu, Ur, Urb, Tb^Tf, Tb^Tf, Urb^Edt, Cud^Edt, Tb^Tf, Cud, Urb^Edt, Uh^Edt, Uh^Edt, Uu^Edt, Cud, Cud^Edt, Uu, Uu^Edt, Rb^Es, Rb^Es, Uu, Uu, Uh, Wwf, Wwf, Wwg, Qxu, Tb^Tf, Wwg, Wwg, Qxu, Uh, Uu, Uu, Tb^Tf, Uu^Es, Uu^Vu, Rb, Tb^Tf, Xu, Xu, Xu, Xu, Xu, Xu, Xu, Xu
Xu, Uu, Uh, Urb, Tb^Tf, Urb^Edt, Cud^Edt, Cud^Edt, Cud, Urb^Edt, Uu, Uh^Edt, Uu, Cud^Edt, Uu, Uu^Edt, Uh^Edt, Uu, Rb^Es, Uu^Es, Tb^Tf, Tb^Tf, Wwg, Wwg, Wwg, Wwg, Uh, Tb^Tf, Wwg, Wwf, Wwf, Uh, Wwg, Uu^Es, Uh, Rb, Wwf, Tb^Tf, Wwg, Xu, Qxu, Qxu, Qxu, Xu, Qxu, Xu
Xu, Xu, Qxu, Uh, Uu, Cud^Edt, Cud^Edt, 3 Kud, Cud^Edb, Cud^Edb, Urb, Uu^Vu, Uu, Uu, Urb, Urb^Edt, Uh^Edt, Uh^Edt, Ur, Rb^Edt, Tb^Tf, Wwf, Wwg, Uh, Wwg, Uh, Qxu, Wwg, Uh, Wwg, Wwg, Wwg, Wwg, Wwg, Wwg, Wwf, Wwg, Wwg, Wwg, Wwg, Qxu, Qxu, Qxu, Qxu, Qxu, Qxu
Xu, Xu, Qxu, Qxu, Uu, Uu, Cud^Edb, Cud^Edb, Cud^Edb, Urb^Edb, Uh, Urb, Uu, Cud, Cud, Uu^Edt, Uu, Uu, Uu^Edt, Uh, Uh, Wwf, Wwg, Tb^Tf, Tb^Tf, Qxu, Qxu, Qxu, Tb^Tf, Uh, Qxu, Wwg, Tb^Tf, Wwg, Wwf, Wwf, Rb, Tb^Tf, Uh, Qxu, Qxu, Qxu, Qxu, Qxu, Qxu, Qxu
Xu, Qxu, Qxu, Qxu, Qxu, Uu, Uu, Uu, Tb^Tf, Uu, Uh, Uh, Uu, Cud, Xu, Uu, Uu, Rb^Edt, Uu^Edt, Uu^Vu, Uh, Uu^Edt, Wwf, Qxu, Qxu, Qxu, Qxu, Wwg, Wwg, Tb^Tf, Qxu, Tb^Tf, Tb^Tf, Ur, Uu, Rb^Es, Uu^Es, Uh, Xu, Xu, Xu, Qxu, Qxu, Qxu, Qxu, Qxu
Xu, Qxu, Qxu, Qxu, Qxu, Qxu, Uu, Tb^Tf, Uu^Vu, Uu, Uh, Uu, Uu, Xu, Xu, Xu, Uu, Rb^Edt, Rb^Edt, Tb^Tf, Ur^Es, Uu, Qxu, Qxu, Wwg, Tb^Tf, Wwg, Wwg, Wwf, Qxu, Qxu, Qxu, Uu^Emf, Ur^Emf, Uu^Emf, Uu^Vu, Ur^Es, Ur, Xu, Xu, Qxu, Qxu, Ce, Qxu, Qxu, Qxu
Xu, Xu, Qxu, Qxu, Qxu, Qxu, Qxu, Uu, Uh, Uh, Uh, Uu, Xu, Xu, Xu, Uu, Uu, Uh, Uh, Tb^Tf, Uu^Es, Uu, Qxu, Qxu, Wwf, Wwg, Rb, Wwf, Tb^Tf, Tb^Tf, Qxu, Qxu, Qxu, Uu^Emf, Xu, Uu, Xu, Xu, Xu, Xu, Tb^Tf, Ce, 4 Ke, Ce, Urb, Xu
Xu, Xu, Xu, Qxu, Qxu, Qxu, Qxu, Qxu, Xu, Uh, Uu, Uh, Xu, Xu, Tb^Tf, Uu^Vu, Tb^Tf, Uu, Uh, Urb, Urb, Uu, Rb, Tb^Tf, Tb^Tf, Rb, Uu, Uu, Qxu, Qxu, Qxu, Qxu, Qxu, Xu, Xu, Xu, Xu, Xu, Xu, Tb^Tf, Ce, Ce, Ce, Ce, Urb^Edt, Xu
Xu, Xu, Xu, Xu, Xu, Xu, Xu, Xu, Xu, Xu, Xu, Xu, Xu, Xu, Xu, Tb^Tf, Xu, Uu, Xu, Xu, Xu, Uu, Uu, Rb, Uu, Uu^Es, Ur^Es, Uu^Es, Uu, Qxu, Tb^Tf, Qxu, Qxu, Qxu, Xu, Xu, Xu, Xu, Xu, Urb, Urb^Edt, Ce, Rb^Edt, Tb^Tf, Xu, Xu
Xu, Xu, Xu, Xu, Xu, Xu, Xu, Xu, Xu, Xu, Xu, Xu, Xu, Xu, Xu, Xu, Xu, Xu, Xu, Xu, Xu, Xu, Uu, Rb, Uu^Vu, Uh^Es, Uh^Es, Uu, Uu, Tb^Tf, Rb, Uu, Qxu, Qxu, Qxu, Xu, Xu, Xu, Xu, Xu, Uu^Edt, Rb^Edt, Tb^Tf, Xu, Xu, Xu
Xu, Xu, Xu, Xu, Xu, Xu, Cud^Edt, Xu, Xu, Xu, Qxu, Xu, Xu, Xu, Xu, Xu, Xu, Xu, Xu, Xu, Xu, Xu, Xu, Uu, Uu, Uh, Uh, Ur^Es, Uh, Rb, Uu, Uu^Vu, Uh, Ur, Tb^Tf, Tb^Tf, Urb, Xu, Uu^Edt, Rb^Edt, Rb^Edt, Tb^Tf, Xu, Xu, Urb, Urb
Xu, Xu, Xu, Xu, Xu, Cud, 6 Kud, Cud^Edt, Uu, Qxu, Qxu, Qxu, Xu, Xu, Qxu, Xu, Qxu, Xu, Xu, Xu, Xu, Xu, Xu, Tb^Tf, Tb^Tf, Rb, Rb, Uh, Tb^Tf, Uh, Rb, Uu, Uu, Ur, Uu, Uu, Uh, Urb, Uu, Rb^Edt, Uu^Edt, Xu, Xu, Xu, Urb^Edt, Uu
Xu, Xu, Xu, Xu, Tb^Tf, Cud, Cud^Edb, Cud^Edb, Uu, Tb^Tf, Tb^Tf, Xu, Xu, Qxu, Qxu, Qxu, Urb, Qxu, Uu, Uh, Uh, Xu, Xu, Xu, Xu, Rb, Uh, Uh, Uh, Uu, Uu, Rb, Xu, Xu, Xu, Xu, Xu, Uh, Xu, Uu^Es, Urb, Tb^Tf, Tb^Tf, Uu^Edt, Uh, Uu^Edt
Xu, Xu, Xu, Xu, Tb^Tf, Uu, Qxu, Qxu, Qxu, Uh^Edb, Uu^Edb, Cud, Rb, Tb^Tf, Qxu, Urb, Urb, Qxu, Qxu, Uu, Urb, Uu^Vu, Xu, Xu, Xu, Uu, Uu, Ur, Uu, Ur, Uu, Rb, Xu, Xu, Xu, Xu, Xu, Xu, Xu, Xu, Urb, Uu, Uu^Vu, Uh, Xu, Xu
Xu, Xu, Xu, Xu, Uu, Uh^Ii, Qxu, Qxu, Qxu, Uh^Edb, Uh^Edb, Cud, Rb, Tb^Tf, Qxu, Urb, Uu^Xo, Urb, Urb, Qxu, Tb^Tf, Urb, Uu, Xu, Rb, Uu, Ur, Uu, Urb, Uu, Ur, Xu, Xu, Xu, Xu, Xu, Xu, Xu, Xu, Xu, Xu, Urb, Rb, Rb, Xu, Xu
Xu, Xu, Cud, Cud^Edt, Cud^Edt, Qxu, Qxu, Qxu, Qxu, Qxu, Cud, Uu, Uh, Qxu, Urb, Urb, Urb, Urb, Urb, Qxu, Qxu, Tb^Tf, Qxu, Rb, Uh, Uu, Ur, Uu^Vu, Urb, Uu, Ur, Uu, Qxu, Qxu, Qxu, Xu, Tb^Tf, Tb^Tf, Xu, Xu, Xu, Tb^Tf, Rb, Xu, Xu, Xu
Xu, Xu, Cud^Edb, 5 Kud, Cud^Edb, Uu, Uh, Uh, Uu, Cud, Rb, Rb, Uh, Qxu, Qxu, Urb, Qxu, Qxu, Qxu, Qxu, Qxu, Qxu, Qxu, Uh, Uu, Ur, Uu, Uu, Uh, Uu, Uu, Ur, Qxu^Bp\, Qxu, Qxu, Urb, Urb, Tb^Tf, Rb, Xu, Rb^Edt, Tb^Tf, Uu^Edt, Xu, Xu, Xu
Xu, Xu, Tb^Tf, Cud^Edb, Rb, Rb, Tb^Tf, Uh, Cud, Uu, Qxu, Qxu, Qxu, Qxu, Urb, Qxu, Qxu, Tb^Tf, Tb^Tf, Qxu, Uh, Qxu, Tb^Tf, Tb^Tf, Uu^Sr, Uu^Edb, Uu^Edb, Uh, Qxu, Qxu, Qxu, Qxu, Qxu, Qxu^Bp\, Uu^Edt, Uu, Tb^Tf, Uu, Rb, Uu^Edt, Tb^Tf, Urb^Edt, Xu, Xu, Xu, Xu
Xu, Xu, Xu, Tb^Tf, Uu, Tb^Tf, Rb^Ii, Rb, Cud, Uu, Qxu, Urb, Urb, Urb, Urb, Urb, Qxu, Uu, Urb^Edb, Urb, Uh, Uu^Edb, Urb^Edb, Uu^Sr, 1 Uh^Sc, Uu^Sr, Ur^Edb, Tb^Tf, Qxu, Qxu, Qxu, Qxu, Qxu, Qxu, Uh, Uu^Edt, Tb^Tf, Uu^Vu, Uu, Uu, Uh, Uh, Xu, Xu, Xu, Xu
Xu, Xu, Xu, Xu, Xu, Xu, Xu, Xu, Xu, Qxu, Qxu, Urb, Urb, Uu^Xo, Urb, Qxu, Uu^Edb, Uu^Edb, Urb^Edb, Tb^Tf, Qxu, Uu^Edb, Urb^Edb, Urb^Sr, Uu^Sr, Uu^Sr, Ur^Edb, Tb^Tf, Qxu, Qxu, Tb^Tf, Tb^Tf, Tb^Tf, Uh, Uu^Edb, Rb, Uu^Edb, Urb, Xu, Xu, Xu, Xu, Xu, Xu, Xu, Xu
Xu, Xu, Xu, Xu, Xu, Xu, Xu, Xu, Qxu, Qxu, Qxu, Qxu, Qxu, Urb, Urb, Qxu, Uu, Tb^Tf, Uh, Qxu, Qxu, Qxu, Qxu, Uu^Edb, Uh, Ur, Uu, Qxu, Qxu, Qxu, Urb^Edb, Urb, Uu^Em, Uu^Em, Rb, Rb^Edb, Urb^Edb, Urb, Xu, Xu, Xu, Xu, Xu, Xu, Xu, Xu
Qxu, Xu, Qxu, Xu, Qxu, Qxu, Qxu, Qxu, Qxu, Qxu, Qxu, Qxu, Qxu, Urb, Qxu, Qxu, Uu^Vu, Uh, Qxu, Qxu, Qxu, Qxu, Qxu, Tb^Tf, Tb^Tf, Uh, Qxu, Qxu, Qxu, Uu^Edb, Uu^Vu, Uu^Edb, Uh, Uu^Em, Xu, Uu, Xu, Xu, Xu, Xu, Xu, Xu, Xu, Xu, Xu, Xu
Qxu, Qxu, Qxu, Qxu, Qxu, Qxu, Qxu, Qxu, Qxu, Qxu, Qxu, Qxu, Qxu, Qxu, Qxu, Tb^Tf, Tb^Tf, Urb, Qxu, Qxu, Qxu, Qxu, Qxu, Uh, Ur^Edt, Ur^Edt, Qxu, Qxu, Tb^Tf, Uu^Edb, Urb^Edt, Uh, Qxu, Xu, Xu, Xu, Xu, Xu, Xu, Xu, Xu, Xu, Xu, Xu, Xu, Xu
Qxu, Qxu, Qxu, Qxu, Qxu, Qxu, Qxu, Qxu, Qxu, Qxu, Qxu, Qxu, Qxu, Qxu, Qxu, Qxu, Qxu, Qxu, Qxu, Qxu, Qxu, Qxu, Rb, Uu^Edt, Ur^Em, Uu, Qxu, Qxu, Tb^Tf, Tb^Tf, Urb^Edt, Uh, Qxu, Xu, Xu, Xu, Xu, Xu, Xu, Xu, Xu, Xu, Xu, Xu, Xu, Xu
Qxu, Qxu, Qxu, Qxu, Qxu, Qxu, Qxu, Qxu, Qxu, Qxu, Qxu, Qxu, Qxu, Qxu, Qxu, Qxu, Qxu, Qxu, Qxu, Qxu, Qxu, Qxu, Rb^Edt, Uu^Edt, Tb^Tf, Tb^Tf, Qxu, Qxu, Qxu, Qxu, Qxu, Qxu, Qxu, Xu, Xu, Xu, Xu, Xu, Xu, Xu, Xu, Xu, Xu, Xu, Xu, Xu
Qxu, Qxu, Qxu, Qxu, Qxu, Qxu, Qxu, Qxu, Qxu, Qxu, Qxu, Qxu, Qxu, Qxu, Qxu, Qxu, Qxu, Qxu, Qxu, Qxu, Qxu, Qxu, Tb^Tf, Ur, Uu, Qxu, Qxu, Qxu, Qxu, Qxu, Qxu, Qxu, Qxu, Qxu, Xu, Xu, Xu, Xu, Xu, Xu, Xu, Xu, Xu, Xu, Xu, Xu
Qxu, Qxu, Qxu, Qxu, Qxu, Qxu, Qxu, Qxu, Qxu, Qxu, Qxu, Qxu, Qxu, Qxu, Qxu, Qxu, Qxu, Qxu, Qxu, Qxu, Qxu, Tb^Tf, Uu, Ur, Uu, Qxu, Qxu, Qxu, Qxu, Qxu, Qxu, Qxu, Qxu, Qxu, Qxu, Xu, Xu, Xu, Xu, Xu, Xu, Xu, Xu, Xu, Xu, Xu
