border_size=1
usage=map

Xu, Xu, Xu, Xu, Xu, Xu, Xu, Xu, Xu, Xu, Xu, Uh, Uu, Uu, Uu, Uh, Xu, Xu, Xu, Xu, Xu, Xu, Xu, Xu, Xu, Xu, Xu, Xu, Xu, Xu, Xu, Xu, Xu, Uu, Uu, Xu, Xu, Xu, Xu, Xu, Xu, Xu, Xu, Uh, Uu, Uu
Xu, Xu, Xu, Xu, Xu, Xu, Xu, Xu, Xu, Xu, Xu, Uh, Uh, Uu^Uf, Uu, Uh, Uh, Xu, Xu, Xu, Xu, Xu, Xu, Xu, Xu, Xu, Xu, Xu, Xu, Xu, Xu, Xu, Rb, Rb, Uu^Uf, Xu, Xu, Xu, Xu, Xu, Xu, Xu, Uh, Uh, Ur, Ur
Xu, Xu, Xu, Xu, Xu, Xu, Xu, Xu, Xu, Xu, Xu, Xu, Xu, Uu^Uf, Rb^Es, Uu^Es, Uh^Es, Xu, Xu, Xu, Xu, Xu, Xu, Xu, Xu, Xu, Uh, Uu^Uf, Ur, Xu, Xu, Xu, Uh^Es, Uu^Uf, Xu, Xu, Xu, Xu, Uu^Uf, Xu, Xu, Xu, Urb, Urb, Uu^Uf, Uu
Xu, Xu, Xu, Xu, Xu, Xu, Qxu, Qxu, Xu, Xu, Xu, Xu, Xu, Uu, Ur, Uu^Vu, Uu, Xu, Xu, Xu, Xu, Xu, Xu, Xu, Uu^Uf, Ur, Ur, Uu^Uf, Ur, Uh, Xu, Xu, Uu^Uf, Uh^Es, Xu, Xu, Xu, Uu^Uf, Co, Uu, Uu, Uh, Co, Uh, Uu^Uf, Uh
Xu, Xu, Xu, Xu, Xu, Xu, Qxu, Qxu, Qxu, Xu, Qxu, Xu, Xu, Xu, Xu, Ur, Uu, Ur, Uu^Uf, Uu^Uf, Ur, Xu, Xu, Xu, Uu, Uu^Uf, Qxu, Qxu, Uu, Rb, Uu^Es, Uu^Es, Uu^Uf, Rb^Es, Xu, Xu, Uu, Uu^Uf, Co, Co, Co, Uh, Urb, Urb, Uh, Uh
Xu, Xu, Uu, Xu, Xu, Qxu, Qxu, Qxu, Qxu, Qxu, Qxu, Qxu, Xu, Xu, Xu, Uh, Uu, Uu^Uf, Uu^Uf, Uu, Ur, Xu, Xu, Xu, Uu, Ur, Qxu, Qxu, Qxu, Rb, Uu^Uf, Uu^Vu, Uu^Es, Xu, Xu, Xu, Ur, Co, Co, 2 Ko, Co, Uu, Xu, Xu, Xu, Xu
Urb, Uu, Uh, Uu^Uf, Uu^Uf, Qxu, Qxu, Qxu, Uh, Uh, Uu^Vu, Uu^Uf, Uu^Uf, Xu, Xu, Xu, Ur, Ur, Uh^Es, Uh^Es, Uu^Es, Uu^Es, Uu^Es, Uu, Uu^Uf, Uu^Uf, Qxu, Qxu, Qxu, Qxu, Uu^Uf, Ur, Uu^Es, Xu, Uu, Ur, Uh, Uu, Uu, Uu, Uu, Uu, Xu, Xu, Xu, Xu
Ur, Urb, Uh, Uu^Vu, Urb^Edt, Uu, Uu^Uf, Uu^Uf, Urb, Uh, Uh^Edt, Uu^Uf, Uu, Xu, Xu, Xu, Uu, Uu, Uu^Vu, Uh^Es, Rb, Uu^Es, Uh, Uu, Qxu, Qxu, Qxu, Qxu, Qxu, Qxu, Qxu, Rb^Es, Uh, Uh, Uu^Es, Uh, Uu^Uf, Uu, Xu, Xu, Xu, Xu, Xu, Xu, Xu, Xu
Uu, Ur, Urb, Uu^Uf, Uu^Uf, Urb^Edt, Cud^Edt, Uu^Uf, Cud, Urb^Edt, Uh^Edt, Uh^Edt, Uu^Edt, Cud, Cud^Edt, Uu, Uu^Edt, Rb^Es, Rb^Es, Uu, Uu, Uh, Wwf, Wwf, Wwg, Qxu, Uu^Uf, Wwg, Wwg, Qxu, Uh, Uu, Uu, Uu^Uf, Uu^Es, Uu^Vu, Rb, Uu^Uf, Xu, Xu, Xu, Xu, Xu, Xu, Xu, Xu
Xu, Uu, Uh, Urb, Uu^Uf, Urb^Edt, Cud^Edt, Cud^Edt, Cud, Urb^Edt, Uu, Uh^Edt, Uu, Cud^Edt, Uu, Uu^Edt, Uh^Edt, Uu, Rb^Es, Uu^Es, Uu^Uf, Uu^Uf, Wwg, Wwg, Wwg, Wwg, Uh, Uu^Uf, Wwg, Wwf, Wwf, Uh, Wwg, Uu^Es, Uh, Rb, Wwf, Uu^Uf, Wwg, Xu, Qxu, Qxu, Qxu, Xu, Qxu, Xu
Xu, Xu, Qxu, Uh, Uu, Cud^Edt, Cud^Edt, 3 Kud, Cud^Edb, Cud^Edb, Urb, Uu^Vu, Uu, Uu, Urb, Urb^Edt, Uh^Edt, Uh^Edt, Ur, Rb^Edt, Uu^Uf, Wwf, Wwg, Uh, Wwg, Uh, Qxu, Wwg, Uh, Wwg, Wwg, Wwg, Wwg, Wwg, Wwg, Wwf, Wwg, Wwg, Wwg, Wwg, Qxu, Qxu, Qxu, Qxu, Qxu, Qxu
Xu, Xu, Qxu, Qxu, Uu, Uu, Cud^Edb, Cud^Edb, Cud^Edb, Urb^Edb, Uh, Urb, Uu, Cud, Cud, Uu^Edt, Uu, Uu, Uu^Edt, Uh, Uh, Wwf, Wwg, Uu^Uf, Uu^Uf, Qxu, Qxu, Qxu, Uu^Uf, Uh, Qxu, Wwg, Uu^Uf, Wwg, Wwf, Wwf, Rb, Uu^Uf, Uh, Qxu, Qxu, Qxu, Qxu, Qxu, Qxu, Qxu
Xu, Qxu, Qxu, Qxu, Qxu, Uu, Uu, Uu, Uu^Uf, Uu, Uh, Uh, Uu, Cud, Xu, Uu, Uu, Rb^Edt, Uu^Edt, Uu^Vu, Uh, Uu^Edt, Wwf, Qxu, Qxu, Qxu, Qxu, Wwg, Wwg, Uu^Uf, Qxu, Uu^Uf, Uu^Uf, Ur, Uu, Rb^Es, Uu^Es, Uh, Xu, Xu, Xu, Qxu, Qxu, Qxu, Qxu, Qxu
Xu, Qxu, Qxu, Qxu, Qxu, Qxu, Uu, Uu^Uf, Uu^Vu, Uu, Uh, Uu, Uu, Xu, Xu, Xu, Uu, Rb^Edt, Rb^Edt, Uu^Uf, Ur^Es, Uu, Qxu, Qxu, Wwg, Uu^Uf, Wwg, Wwg, Wwf, Qxu, Qxu, Qxu, Uu^Emf, Ur^Emf, Uu^Emf, Uu^Vu, Ur^Es, Ur, Xu, Xu, Qxu, Qxu, Ce, Qxu, Qxu, Qxu
Xu, Xu, Qxu, Qxu, Qxu, Qxu, Qxu, Uu, Uh, Uh, Uh, Uu, Xu, Xu, Xu, Uu, Uu, Uh, Uh, Uu^Uf, Uu^Es, Uu, Qxu, Qxu, Wwf, Wwg, Rb, Wwf, Uu^Uf, Uu^Uf, Qxu, Qxu, Qxu, Uu^Emf, Xu, Uu, Xu, Xu, Xu, Xu, Uu^Uf, Ce, 4 Ke, Ce, Urb, Xu
Xu, Xu, Xu, Qxu, Qxu, Qxu, Qxu, Qxu, Xu, Uh, Uu, Uh, Xu, Xu, Uu^Uf, Uu^Vu, Uu^Uf, Uu, Uh, Urb, Urb, Uu, Rb, Uu^Uf, Uu^Uf, Rb, Uu, Uu, Qxu, Qxu, Qxu, Qxu, Qxu, Xu, Xu, Xu, Xu, Xu, Xu, Uu^Uf, Ce, Ce, Ce, Ce, Urb^Edt, Xu
Xu, Xu, Xu, Xu, Xu, Xu, Xu, Xu, Xu, Xu, Xu, Xu, Xu, Xu, Xu, Uu^Uf, Xu, Uu, Xu, Xu, Xu, Uu, Uu, Rb, Uu, Uu^Es, Ur^Es, Uu^Es, Uu, Qxu, Uu^Uf, Qxu, Qxu, Qxu, Xu, Xu, Xu, Xu, Xu, Urb, Urb^Edt, Ce, Rb^Edt, Uu^Uf, Xu, Xu
Xu, Xu, Xu, Xu, Xu, Xu, Xu, Xu, Xu, Xu, Xu, Xu, Xu, Xu, Xu, Xu, Xu, Xu, Xu, Xu, Xu, Xu, Uu, Rb, Uu^Vu, Uh^Es, Uh^Es, Uu, Uu, Uu^Uf, Rb, Uu, Qxu, Qxu, Qxu, Xu, Xu, Xu, Xu, Xu, Uu^Edt, Rb^Edt, Uu^Uf, Xu, Xu, Xu
Xu, Xu, Xu, Xu, Xu, Xu, Cud^Edt, Xu, Xu, Xu, Qxu, Xu, Xu, Xu, Xu, Xu, Xu, Xu, Xu, Xu, Xu, Xu, Xu, Uu, Uu, Uh, Uh, Ur^Es, Uh, Rb, Uu, Uu^Vu, Uh, Ur, Uu^Uf, Uu^Uf, Urb, Xu, Uu^Edt, Rb^Edt, Rb^Edt, Uu^Uf, Xu, Xu, Urb, Urb
Xu, Xu, Xu, Xu, Xu, Cud, 6 Kud, Cud^Edt, Uu, Qxu, Qxu, Qxu, Xu, Xu, Qxu, Xu, Qxu, Xu, Xu, Xu, Xu, Xu, Xu, Uu^Uf, Uu^Uf, Rb, Rb, Uh, Uu^Uf, Uh, Rb, Uu, Uu, Ur, Uu, Uu, Uh, Urb, Uu, Rb^Edt, Uu^Edt, Xu, Xu, Xu, Urb^Edt, Uu
Xu, Xu, Xu, Xu, Uu^Uf, Cud, Cud^Edb, Cud^Edb, Uu, Uu^Uf, Uu^Uf, Xu, Xu, Qxu, Qxu, Qxu, Urb, Qxu, Uu, Uh, Uh, Xu, Xu, Xu, Xu, Rb, Uh, Uh, Uh, Uu, Uu, Rb, Xu, Xu, Xu, Xu, Xu, Uh, Xu, Uu^Es, Urb, Uu^Uf, Uu^Uf, Uu^Edt, Uh, Uu^Edt
Xu, Xu, Xu, Xu, Uu^Uf, Uu, Qxu, Qxu, Qxu, Uh^Edb, Uu^Edb, Cud, Rb, Uu^Uf, Qxu, Urb, Urb, Qxu, Qxu, Uu, Urb, Uu^Vu, Xu, Xu, Xu, Uu, Uu, Ur, Uu, Ur, Uu, Rb, Xu, Xu, Xu, Xu, Xu, Xu, Xu, Xu, Urb, Uu, Uu^Vu, Uh, Xu, Xu
Xu, Xu, Xu, Xu, Uu, Uh^Ii, Qxu, Qxu, Qxu, Uh^Edb, Uh^Edb, Cud, Rb, Uu^Uf, Qxu, Urb, Uu^Xo, Urb, Urb, Qxu, Uu^Uf, Urb, Uu, Xu, Rb, Uu, Ur, Uu, Urb, Uu, Ur, Xu, Xu, Xu, Xu, Xu, Xu, Xu, Xu, Xu, Xu, Urb, Rb, Rb, Xu, Xu
Xu, Xu, Cud, Cud^Edt, Cud^Edt, Qxu, Qxu, Qxu, Qxu, Qxu, Cud, Uu, Uh, Qxu, Urb, Urb, Urb, Urb, Urb, Qxu, Qxu, Uu^Uf, Qxu, Rb, Uh, Uu, Ur, Uu^Vu, Urb, Uu, Ur, Uu, Qxu, Qxu, Qxu, Xu, Uu^Uf, Uu^Uf, Xu, Xu, Xu, Uu^Uf, Rb, Xu, Xu, Xu
Xu, Xu, Cud^Edb, 5 Kud, Cud^Edb, Uu, Uh, Uh, Uu, Cud, Rb, Rb, Uh, Qxu, Qxu, Urb, Qxu, Qxu, Qxu, Qxu, Qxu, Qxu, Qxu, Uh, Uu, Ur, Uu, Uu, Uh, Uu, Uu, Ur, Qxu^Bp\, Qxu, Qxu, Urb, Urb, Uu^Uf, Rb, Xu, Rb^Edt, Uu^Uf, Uu^Edt, Xu, Xu, Xu
Xu, Xu, Uu^Uf, Cud^Edb, Rb, Rb, Uu^Uf, Uh, Cud, Uu, Qxu, Qxu, Qxu, Qxu, Urb, Qxu, Qxu, Uu^Uf, Uu^Uf, Qxu, Uh, Qxu, Uu^Uf, Uu^Uf, Uu^Sr, Uu^Edb, Uu^Edb, Uh, Qxu, Qxu, Qxu, Qxu, Qxu, Qxu^Bp\, Uu^Edt, Uu, Uu^Uf, Uu, Rb, Uu^Edt, Uu^Uf, Urb^Edt, Xu, Xu, Xu, Xu
Xu, Xu, Xu, Uu^Uf, Uu, Uu^Uf, Rb^Ii, Rb, Cud, Uu, Qxu, Urb, Urb, Urb, Urb, Urb, Qxu, Uu, Urb^Edb, Urb, Uh, Uu^Edb, Urb^Edb, Uu^Sr, 1 Uh^Sc, Uu^Sr, Ur^Edb, Uu^Uf, Qxu, Qxu, Qxu, Qxu, Qxu, Qxu, Uh, Uu^Edt, Uu^Uf, Uu^Vu, Uu, Uu, Uh, Uh, Xu, Xu, Xu, Xu
Xu, Xu, Xu, Xu, Xu, Xu, Xu, Xu, Xu, Qxu, Qxu, Urb, Urb, Uu^Xo, Urb, Qxu, Uu^Edb, Uu^Edb, Urb^Edb, Uu^Uf, Qxu, Uu^Edb, Urb^Edb, Urb^Sr, Uu^Sr, Uu^Sr, Ur^Edb, Uu^Uf, Qxu, Qxu, Uu^Uf, Uu^Uf, Uu^Uf, Uh, Uu^Edb, Rb, Uu^Edb, Urb, Xu, Xu, Xu, Xu, Xu, Xu, Xu, Xu
Xu, Xu, Xu, Xu, Xu, Xu, Xu, Xu, Qxu, Qxu, Qxu, Qxu, Qxu, Urb, Urb, Qxu, Uu, Uu^Uf, Uh, Qxu, Qxu, Qxu, Qxu, Uu^Edb, Uh, Ur, Uu, Qxu, Qxu, Qxu, Urb^Edb, Urb, Uu^Em, Uu^Em, Rb, Rb^Edb, Urb^Edb, Urb, Xu, Xu, Xu, Xu, Xu, Xu, Xu, Xu
Qxu, Xu, Qxu, Xu, Qxu, Qxu, Qxu, Qxu, Qxu, Qxu, Qxu, Qxu, Qxu, Urb, Qxu, Qxu, Uu^Vu, Uh, Qxu, Qxu, Qxu, Qxu, Qxu, Uu^Uf, Uu^Uf, Uh, Qxu, Qxu, Qxu, Uu^Edb, Uu^Vu, Uu^Edb, Uh, Uu^Em, Xu, Uu, Xu, Xu, Xu, Xu, Xu, Xu, Xu, Xu, Xu, Xu
Qxu, Qxu, Qxu, Qxu, Qxu, Qxu, Qxu, Qxu, Qxu, Qxu, Qxu, Qxu, Qxu, Qxu, Qxu, Uu^Uf, Uu^Uf, Urb, Qxu, Qxu, Qxu, Qxu, Qxu, Uh, Ur^Edt, Ur^Edt, Qxu, Qxu, Uu^Uf, Uu^Edb, Urb^Edt, Uh, Qxu, Xu, Xu, Xu, Xu, Xu, Xu, Xu, Xu, Xu, Xu, Xu, Xu, Xu
Qxu, Qxu, Qxu, Qxu, Qxu, Qxu, Qxu, Qxu, Qxu, Qxu, Qxu, Qxu, Qxu, Qxu, Qxu, Qxu, Qxu, Qxu, Qxu, Qxu, Qxu, Qxu, Rb, Uu^Edt, Ur^Em, Uu, Qxu, Qxu, Uu^Uf, Uu^Uf, Urb^Edt, Uh, Qxu, Xu, Xu, Xu, Xu, Xu, Xu, Xu, Xu, Xu, Xu, Xu, Xu, Xu
Qxu, Qxu, Qxu, Qxu, Qxu, Qxu, Qxu, Qxu, Qxu, Qxu, Qxu, Qxu, Qxu, Qxu, Qxu, Qxu, Qxu, Qxu, Qxu, Qxu, Qxu, Qxu, Rb^Edt, Uu^Edt, Uu^Uf, Uu^Uf, Qxu, Qxu, Qxu, Qxu, Qxu, Qxu, Qxu, Xu, Xu, Xu, Xu, Xu, Xu, Xu, Xu, Xu, Xu, Xu, Xu, Xu
Qxu, Qxu, Qxu, Qxu, Qxu, Qxu, Qxu, Qxu, Qxu, Qxu, Qxu, Qxu, Qxu, Qxu, Qxu, Qxu, Qxu, Qxu, Qxu, Qxu, Qxu, Qxu, Uu^Uf, Ur, Uu, Qxu, Qxu, Qxu, Qxu, Qxu, Qxu, Qxu, Qxu, Qxu, Xu, Xu, Xu, Xu, Xu, Xu, Xu, Xu, Xu, Xu, Xu, Xu
Qxu, Qxu, Qxu, Qxu, Qxu, Qxu, Qxu, Qxu, Qxu, Qxu, Qxu, Qxu, Qxu, Qxu, Qxu, Qxu, Qxu, Qxu, Qxu, Qxu, Qxu, Uu^Uf, Uu, Ur, Uu, Qxu, Qxu, Qxu, Qxu, Qxu, Qxu, Qxu, Qxu, Qxu, Qxu, Xu, Xu, Xu, Xu, Xu, Xu, Xu, Xu, Xu, Xu, Xu
