Xu, Xu, Xu, Xu, Xu, Xu, Xu, Xu, Xu, Xu, Xu, Uh, Uu, Uu, Uu, Uh, Xu, Xu, Xu, Xu, Xu, Xu, Xu, Xu, Xu, Xu, Xu, Xu, Xu, Xu, Xu, Xu, Xu, Uu, Uu, Xu, Xu, Xu, Xu, Xu, Xu, Xu, Xu, Uh, Uu, Uu
Xu, Xu, Xu, Xu, Xu, Xu, Xu, Xu, Xu, Xu, Xu, Uh, Uh, Uu^Tf, Uu, Uh, Uh, Xu, Xu, Xu, Xu, Xu, Xu, Xu, Xu, Xu, Xu, Xu, Xu, Xu, Xu, Xu, Rb, Rb, Uu^Tf, Xu, Xu, Xu, Xu, Xu, Xu, Xu, Uh, Uh, Ur, Ur
Xu, Xu, Xu, Xu, Xu, Xu, Xu, Xu, Xu, Xu, Xu, Xu, Xu, Uu^Tf, Rb^Es, Uu^Es, Uh^Es, Xu, Xu, Xu, Xu, Xu, Xu, Xu, Xu, Xu, Uh, Uu^Tf, Ur, Xu, Xu, Xu, Uh^Es, Uu^Tf, Xu, Xu, Xu, Xu, Tb^Tf, Xu, Xu, Xu, Urb, Urb, Tb^Tf, Uu
Xu, Xu, Xu, Xu, Xu, Xu, Qxu, Qxu, Xu, Xu, Xu, Xu, Xu, Uu, Ur, Uu^Vu, Uu, Xu, Xu, Xu, Xu, Xu, Xu, Xu, Uu^Tf, Ur, Ur, Uu^Tf, Ur, Uh, Xu, Xu, Uu^Tf, Uh^Es, Xu, Xu, Xu, Tb^Tf, Co, Uu, Uu, Uh, Co, Uh, Tb^Tf, Uh
Xu, Xu, Xu, Xu, Xu, Xu, Qxu, Qxu, Qxu, Xu, Qxu, Xu, Xu, Xu, Xu, Ur, Uu, Ur, Uu^Tf, Uu^Tf, Ur, Xu, Xu, Xu, Uu, Uu^Tf, Qxu, Qxu, Uu, Rb, Uu^Es, Uu^Es, Uu^Tf, Rb^Es, Xu, Xu, Uu, Tb^Tf, Co, Co, Co, Uh, Urb, Urb, Uh, Uh
Xu, Xu, Uu, Xu, Xu, Qxu, Qxu, Qxu, Qxu, Qxu, Qxu, Qxu, Xu, Xu, Xu, Uh, Uu, Uu^Tf, Uu^Tf, Uu, Ur, Xu, Xu, Xu, Uu, Ur, Qxu, Qxu, Qxu, Rb, Uu^Tf, Uu^Vu, Uu^Es, Xu, Xu, Xu, Ur, Co, Co, 2 Ko, Co, Uu, Xu, Xu, Xu, Xu
Urb, Uu, Uh, Uu^Tf, Uu^Tf, Qxu, Qxu, Qxu, Uh, Uh, Uu^Vu, Uu^Tf, Uu^Tf, Xu, Xu, Xu, Ur, Ur, Uh^Es, Uh^Es, Uu^Es, Uu^Es, Uu^Es, Uu, Uu^Tf, Uu^Tf, Qxu, Qxu, Qxu, Qxu, Uu^Tf, Ur, Uu^Es, Xu, Uu, Ur, Uh, Uu, Uu, Uu, Uu, Uu, Xu, Xu, Xu, Xu
Ur, Urb, Uh, Uu^Vu, Urb^Edt, Uu, Uu^Tf, Uu^Tf, Urb, Uh, Uh^Edt, Uu^Tf, Uu, Xu, Xu, Xu, Uu, Uu, Uu^Vu, Uh^Es, Rb, Uu^Es, Uh, Uu, Qxu, Qxu, Qxu, Qxu, Qxu, Qxu, Qxu, Rb^Es, Uh, Uh, Uu^Es, Uh, Uu^Tf, Uu, Xu, Xu, Xu, Xu, Xu, Xu, Xu, Xu
Uu, Ur, Urb, Uu^Tf, Uu^Tf, Urb^Edt, Cud^Edt, Uu^Tf, Cud, Urb^Edt, Uh^Edt, Uh^Edt, Uu^Edt, Cud, Cud^Edt, Uu, Uu^Edt, Rb^Es, Rb^Es, Uu, Uu, Uh, Wwf, Wwf, Wwg, Qxu, Uu^Tf, Wwg, Wwg, Qxu, Uh, Uu, Uu, Uu^Tf, Uu^Es, Uu^Vu, Rb, Uu^Tf, Xu, Xu, Xu, Xu, Xu, Xu, Xu, Xu
Xu, Uu, Uh, Urb, Uu^Tf, Urb^Edt, Cud^Edt, Cud^Edt, Cud, Urb^Edt, Uu, Uh^Edt, Uu, Cud^Edt, Uu, Uu^Edt, Uh^Edt, Uu, Rb^Es, Uu^Es, Uu^Tf, Uu^Tf, Wwg, Wwg, Wwg, Wwg, Uh, Uu^Tf, Wwg, Wwf, Wwf, Uh, Wwg, Uu^Es, Uh, Rb, Wwf, Uu^Tf, Wwg, Xu, Qxu, Qxu, Qxu, Xu, Qxu, Xu
Xu, Xu, Qxu, Uh, Uu, Cud^Edt, Cud^Edt, 3 Kud, Cud^Edb, Cud^Edb, Urb, Uu^Vu, Uu, Uu, Urb, Urb^Edt, Uh^Edt, Uh^Edt, Ur, Rb^Edt, Uu^Tf, Wwf, Wwg, Uh, Wwg, Uh, Qxu, Wwg, Uh, Wwg, Wwg, Wwg, Wwg, Wwg, Wwg, Wwf, Wwg, Wwg, Wwg, Wwg, Qxu, Qxu, Qxu, Qxu, Qxu, Qxu
Xu, Xu, Qxu, Qxu, Uu, Uu, Cud^Edb, Cud^Edb, Cud^Edb, Urb^Edb, Uh, Urb, Uu, Cud, Cud, Uu^Edt, Uu, Uu, Uu^Edt, Uh, Uh, Wwf, Wwg, Uu^Tf, Uu^Tf, Qxu, Qxu, Qxu, Uu^Tf, Uh, Qxu, Wwg, Uu^Tf, Wwg, Wwf, Wwf, Rb, Uu^Tf, Uh, Qxu, Qxu, Qxu, Qxu, Qxu, Qxu, Qxu
Xu, Qxu, Qxu, Qxu, Qxu, Uu, Uu, Uu, Uu^Tf, Uu, Uh, Uh, Uu, Cud, Xu, Uu, Uu, Rb^Edt, Uu^Edt, Uu^Vu, Uh, Uu^Edt, Wwf, Qxu, Qxu, Qxu, Qxu, Wwg, Wwg, Uu^Tf, Qxu, Uu^Tf, Uu^Tf, Ur, Uu, Rb^Es, Uu^Es, Uh, Xu, Xu, Xu, Qxu, Qxu, Qxu, Qxu, Qxu
Xu, Qxu, Qxu, Qxu, Qxu, Qxu, Uu, Uu^Tf, Uu^Vu, Uu, Uh, Uu, Uu, Xu, Xu, Xu, Uu, Rb^Edt, Rb^Edt, Uu^Tf, Ur^Es, Uu, Qxu, Qxu, Wwg, Uu^Tf, Wwg, Wwg, Wwf, Qxu, Qxu, Qxu, Uu^Emf, Ur^Emf, Uu^Emf, Uu^Vu, Ur^Es, Ur, Xu, Xu, Qxu, Qxu, Ce, Qxu, Qxu, Qxu
Xu, Xu, Qxu, Qxu, Qxu, Qxu, Qxu, Uu, Uh, Uh, Uh, Uu, Xu, Xu, Xu, Uu, Uu, Uh, Uh, Uu^Tf, Uu^Es, Uu, Qxu, Qxu, Wwf, Wwg, Rb, Wwf, Uu^Tf, Uu^Tf, Qxu, Qxu, Qxu, Uu^Emf, Xu, Uu, Xu, Xu, Xu, Xu, Uu^Tf, Ce, 4 Ke, Ce, Urb, Xu
Xu, Xu, Xu, Qxu, Qxu, Qxu, Qxu, Qxu, Xu, Uh, Uu, Uh, Xu, Xu, Uu^Tf, Uu^Vu, Uu^Tf, Uu, Uh, Urb, Urb, Uu, Rb, Uu^Tf, Uu^Tf, Rb, Uu, Uu, Qxu, Qxu, Qxu, Qxu, Qxu, Xu, Xu, Xu, Xu, Xu, Xu, Uu^Tf, Ce, Ce, Ce, Ce, Urb^Edt, Xu
Xu, Xu, Xu, Xu, Xu, Xu, Xu, Xu, Xu, Xu, Xu, Xu, Xu, Xu, Xu, Uu^Tf, Xu, Uu, Xu, Xu, Xu, Uu, Uu, Rb, Uu, Uu^Es, Ur^Es, Uu^Es, Uu, Qxu, Uu^Tf, Qxu, Qxu, Qxu, Xu, Xu, Xu, Xu, Xu, Urb, Urb^Edt, Ce, Rb^Edt, Uu^Tf, Xu, Xu
Xu, Xu, Uu, Ias, Uh, Uh, Xu, Xu, Xu, Xu, Xu, Xu, Xu, Xu, Xu, Xu, Xu, Xu, Xu, Xu, Xu, Xu, Uu, Rb, Uu^Vu, Uh^Es, Uh^Es, Uu, Uu, Uu^Tf, Rb, Uu, Qxu, Qxu, Qxu, Xu, Xu, Xu, Xu, Xu, Uu^Edt, Rb^Edt, Uu^Tf, Xu, Xu, Xu
Xu, Xu, Ias, Ias, Ias, Uh, Cud^Edt, Xu, Xu, Xu, Qxu, Xu, Xu, Xu, Xu, Xu, Xu, Xu, Xu, Xu, Xu, Xu, Xu, Uu, Uu, Uh, Uh, Ur^Es, Uh, Rb, Uu, Uu^Vu, Uh, Ur, Uu^Tf, Uu^Tf, Urb, Xu, Uu^Edt, Rb^Edt, Rb^Edt, Uu^Tf, Xu, Xu, Urb, Urb
Xu, Xu, Xu, Uu, Uu, Cud, 6 Kud, Cud^Edt, Uu, Qxu, Qxu, Qxu, Xu, Xu, Qxu, Xu, Qxu, Xu, Xu, Xu, Xu, Xu, Xu, Uu^Tf, Uu^Tf, Rb, Rb, Uh, Uu^Tf, Uh, Rb, Uu, Uu, Ur, Uu, Uu, Uh, Urb, Uu, Rb^Edt, Uu^Edt, Xu, Xu, Xu, Urb^Edt, Uu
Xu, Xu, Xu, Xu, Uu^Tf, Cud, Cud^Edb, Cud^Edb, Uu, Uu^Tf, Uu^Tf, Xu, Xu, Qxu, Qxu, Qxu, Urb, Qxu, Uu, Uh, Uh, Xu, Xu, Xu, Xu, Rb, Uh, Uh, Uh, Uu, Uu, Rb, Xu, Xu, Xu, Xu, Xu, Uh, Xu, Uu^Es, Urb, Uu^Tf, Uu^Tf, Uu^Edt, Uh, Uu^Edt
Xu, Xu, Xu, Xu, Uu^Tf, Uu, Qxu, Qxu, Qxu, Uh^Edb, Uu^Edb, Cud, Rb, Uu^Tf, Qxu, Urb, Urb, Qxu, Qxu, Uu, Urb, Uu^Vu, Xu, Xu, Xu, Uu, Uu, Ur, Uu, Ur, Uu, Rb, Xu, Xu, Xu, Xu, Xu, Xu, Xu, Xu, Urb, Uu, Uu^Vu, Uh, Xu, Xu
Xu, Xu, Xu, Xu, Uu, Uh^Ii, Qxu, Qxu, Qxu, Uh^Edb, Uh^Edb, Cud, Rb, Uu^Tf, Qxu, Urb, Uu^Xo, Urb, Urb, Qxu, Uu^Tf, Urb, Uu, Xu, Rb, Uu, Ur, Uu, Urb, Uu, Ur, Xu, Xu, Xu, Xu, Xu, Xu, Xu, Xu, Xu, Xu, Urb, Rb, Rb, Xu, Xu
Xu, Xu, Cud, Cud^Edt, Cud^Edt, Qxu, Qxu, Qxu, Qxu, Qxu, Cud, Uu, Uh, Qxu, Urb, Urb, Urb, Urb, Urb, Qxu, Qxu, Uu^Tf, Qxu, Rb, Uh, Uu, Ur, Uu^Vu, Urb, Uu, Ur, Uu, Qxu, Qxu, Qxu, Xu, Uu^Tf, Tb^Tf, Xu, Xu, Xu, Uu^Tf, Rb, Xu, Xu, Xu
Xu, Xu, Cud^Edb, 5 Kud, Cud^Edb, Uu, Uh, Uh, Uu, Cud, Rb, Rb, Uh, Qxu, Qxu, Urb, Qxu, Qxu, Qxu, Qxu, Qxu, Qxu, Qxu, Uh, Uu, Ur, Uu, Uu, Uh, Uu, Uu, Ur, Qxu^Bp\, Qxu, Qxu, Urb, Urb, Uu^Tf, Rb, Xu, Rb^Edt, Uu^Tf, Uu^Edt, Xu, Xu, Xu
Xu, Xu, Uu^Tf, Cud^Edb, Rb, Rb, Uu^Tf, Uh, Cud, Uu, Qxu, Qxu, Qxu, Qxu, Urb, Qxu, Qxu, Uu^Tf, Uu^Tf, Qxu, Uh, Qxu, Uu^Tf, Uu^Tf, Uu^Sr, Uu^Edb, Uu^Edb, Uh, Qxu, Qxu, Qxu, Qxu, Qxu, Qxu^Bp\, Uu^Edt, Uu, Uu^Tf, Uu, Rb, Uu^Edt, Uu^Tf, Urb^Edt, Xu, Xu, Xu, Xu
Xu, Xu, Xu, Uu^Tf, Uu, Uu^Tf, Rb^Ii, Rb, Cud, Uu, Qxu, Urb, Urb, Urb, Urb, Urb, Qxu, Uu, Urb^Edb, Urb, Uh, Uu^Edb, Urb^Edb, Uu^Sr, 1 Uh^Sc, Uu^Sr, Ur^Edb, Tb^Tf, Qxu, Qxu, Qxu, Qxu, Qxu, Qxu, Uh, Uu^Edt, Uu^Tf, Uu^Vu, Uu, Uu, Uh, Uh, Xu, Xu, Xu, Xu
Xu, Xu, Xu, Xu, Xu, Xu, Xu, Xu, Xu, Qxu, Qxu, Urb, Urb, Uu^Xo, Urb, Qxu, Uu^Edb, Uu^Edb, Urb^Edb, Uu^Tf, Qxu, Uu^Edb, Urb^Edb, Urb^Sr, Uu^Sr, Uu^Sr, Ur^Edb, Tb^Tf, Qxu, Qxu, Uu^Tf, Uu^Tf, Uu^Tf, Uh, Uu^Edb, Rb, Uu^Edb, Urb, Xu, Xu, Xu, Xu, Xu, Xu, Xu, Xu
Xu, Xu, Xu, Xu, Xu, Xu, Xu, Xu, Qxu, Qxu, Qxu, Qxu, Qxu, Urb, Urb, Qxu, Uu, Uu^Tf, Uh, Qxu, Qxu, Qxu, Qxu, Uu^Edb, Uh, Ur, Uu, Qxu, Qxu, Qxu, Urb^Edb, Urb, Uu^Em, Uu^Em, Rb, Rb^Edb, Urb^Edb, Urb, Xu, Xu, Xu, Xu, Xu, Xu, Xu, Xu
Qxu, Xu, Qxu, Xu, Qxu, Qxu, Qxu, Qxu, Qxu, Qxu, Qxu, Qxu, Qxu, Urb, Qxu, Qxu, Uu^Vu, Uh, Qxu, Qxu, Qxu, Qxu, Qxu, Uu^Tf, Uu^Tf, Uh, Qxu, Qxu, Qxu, Uu^Edb, Uu^Vu, Uu^Edb, Uh, Uu^Em, Xu, Uu, Xu, Xu, Xu, Xu, Xu, Xu, Xu, Xu, Xu, Xu
Qxu, Qxu, Qxu, Qxu, Qxu, Qxu, Qxu, Qxu, Qxu, Qxu, Qxu, Qxu, Qxu, Qxu, Qxu, Uu^Tf, Uu^Tf, Urb, Qxu, Qxu, Qxu, Qxu, Qxu, Uh, Ur^Edt, Ur^Edt, Qxu, Qxu, Uu^Tf, Uu^Edb, Urb^Edt, Uh, Qxu, Xu, Xu, Xu, Xu, Xu, Xu, Xu, Xu, Xu, Xu, Xu, Xu, Xu
Qxu, Qxu, Qxu, Qxu, Qxu, Qxu, Qxu, Qxu, Qxu, Qxu, Qxu, Qxu, Qxu, Qxu, Qxu, Qxu, Qxu, Qxu, Qxu, Qxu, Qxu, Qxu, Rb, Uu^Edt, Ur^Em, Uu, Qxu, Qxu, Uu^Tf, Uu^Tf, Urb^Edt, Uh, Qxu, Xu, Xu, Xu, Xu, Xu, Xu, Xu, Xu, Xu, Xu, Xu, Xu, Xu
Qxu, Qxu, Qxu, Qxu, Qxu, Qxu, Qxu, Qxu, Qxu, Qxu, Qxu, Qxu, Qxu, Qxu, Qxu, Qxu, Qxu, Qxu, Qxu, Qxu, Qxu, Qxu, Rb^Edt, Uu^Edt, Uu^Tf, Uu^Tf, Qxu, Qxu, Qxu, Qxu, Qxu, Qxu, Qxu, Xu, Xu, Xu, Xu, Xu, Xu, Xu, Xu, Xu, Xu, Xu, Xu, Xu
Qxu, Qxu, Qxu, Qxu, Qxu, Qxu, Qxu, Qxu, Qxu, Qxu, Qxu, Qxu, Qxu, Qxu, Qxu, Qxu, Qxu, Qxu, Qxu, Qxu, Qxu, Qxu, Uu^Tf, Ur, Uu, Qxu, Qxu, Qxu, Qxu, Qxu, Qxu, Qxu, Qxu, Qxu, Xu, Xu, Xu, Xu, Xu, Xu, Xu, Xu, Xu, Xu, Xu, Xu
Qxu, Qxu, Qxu, Qxu, Qxu, Qxu, Qxu, Qxu, Qxu, Qxu, Qxu, Qxu, Qxu, Qxu, Qxu, Qxu, Qxu, Qxu, Qxu, Qxu, Qxu, Uu^Tf, Uu, Ur, Uu, Qxu, Qxu, Qxu, Qxu, Qxu, Qxu, Qxu, Qxu, Qxu, Qxu, Xu, Xu, Xu, Xu, Xu, Xu, Xu, Xu, Xu, Xu, Xu
