border_size=1
usage=map

Xu, Xu, Xu, Xu, Xu, Xu, Xu, Xu, Xu, Xu, Xu, Xu, Xu, Xu, Xu, Xu, Xu, Xu, Xu, Xu, Xu, Xu, Xu, Xu, Xu, Xu, Xu, Xu, Xu, Xu, Xu, Xu, Xu, Xu, Xu, Xu, Xu, Xu, Xu, Xu, Xu, Xu, Xu, Xu, Xu, Xu
Xu, Xu, Urb^Sr, Xu, Xu, Xu, Xu, Xu, Xu, Xu, Xu, Xu, Xu, Xu, Xu, Xu, Urb^Sr, Xu, Xu, Xu, Xu, Xu, Xu, Xu, Urb^Sr, Xu, Urb^Sr, Xu, Xu, Xu, Xu, Xu, Xu, Xu, Xu, Xu, Xu, Xu, Xu, Xu, Xu, Xu, Urb^Sr, Xu, Xu, Xu
Xu, Xu, Xu, Xu, Uh, Xu, Uu, Uu, Uu^Ufi, Xu, Urb^Sr, Xu, Xu, Uu^Uf, Uh, Xu, Xu, Xu, Qxu, Qxu, Qxu, Qxu, Qxu, Xu, Xu, Xu, Xu, Xu, Qxu, Qxu, Qxu, Xu, Xu, Urb^Sr, Xu, Xu, Qxu, Xu, Uu, Uu^Uf, Uu^Uf, Xu, Xu, Xu, Xu, Xu
Xu, Xu, Xu, Uu^Uf, Uh^Ecf, Uh, Ce, Uu^Ufi, Uu, Xu, Xu, Xu, Sm, Uh, Uu, Xu, Xu, Qxu, Qxu, Qxu, Qxu, Qxu, Qxu, Qxu, Xu, Urb^Sr, Xu, Qxu, Qxu, Qxu, Xu, Xu, Xu, Xu, Qxu, Qxu, Urb, Qxu, Uu, Cud^Ii, Ur, Uh, Xu, Urb^Sr, Xu, Xu
Xu, Urb^Sr, Xu, Uu, Uu^Uf, Ce, Ke, Ce, Uu^Uf, Uu, Xu, Xu, Sm, Rp, Rp^Vhcr, Uu, Uh, Qxu, Qxu, Qxu, Xu, Xu, Xu, Qxu, Qxu, Xu, Urb^Sr, Xu, Qxu, Qxu, Xu, Urb^Sr, Xu, Qxu, Qxu, Urb, Urb, Qxu, Qxu, Ur, Qxu, Uh, Xu, Xu, Xu, Xu
Xu, Xu, Xu, Uu, Uh, Ce, Ce, Ce, Rb, Uh, Ur, Uu, Uu, Rp, Sm, Sm, Uu^Uf, Rp, Qxu, Qxu, Xu, Urb^Sr, Urb^Sr, Xu, Qxu, Xu, Xu, Xu, Rp^Vhcr, Uu, Uh, Xu, Qxu, Qxu, Qxu, Urb, Xos, Urb, Urb, Qxu, Qxu, Qxu, Xu, Urb^Sr, Xu, Xu
Xu, Xu, Urb^Sr, Xu, Uu, Uh, Uu^Uf, Uh, Rb, Uh, Uh, Ur, Sm, Uu^Ufi, Uu, Sm, Xu, Xu, Xu, Qxu, Qxu, Xu, Xu, Xu, Qxu, Qxu, Qxu, Qxu, Xu, Rp, Uh, Uu, Uu, Qxu, Urb, Urb, Urb, Urb, Urb, Qxu, Qxu, Qxu, Xu, Xu, Xu, Xu
Xu, Xu, Xu, Xu, Xu, Uu^Uf, Xu, Xu, Xu, Uu, Xu, Xu, Uu^Uf, Sm, Rp, Uh, Xu, Urb^Sr, Xu, Qxu, Qxu, Qxu, Qxu, Qxu, Qxu, Qxu, Qxu, Qxu, Xu, Xu, Uu, Rp, Uu, Qxu, Qxu, Urb, Qxu, Qxu, Qxu, Qxu, Qxu, Xu, Urb^Sr, Xu, Xu, Xu
Xu, Xu, Xu, Xu, Urb^Sr, Xu, Xu, Xu, Xu, Xu, Xu, Xu, Uu, Sm, Rp, Uh, Sm, Xu, Qxu, Qxu, Qxu, Qxu, Xu, Xu, Xu, Qxu, Qxu, Xu, Xu, Xu, Uu^Uf, Rp, Rp, Uu^Uf, Uh, Ur, Qxu, Qxu, Qxu, Qxu, Qxu, Xu, Xu, Xu, Xu, Xu
Xu, Xu, Xu, Xu, Xu, Xu, Sm, Sm, Uu, Xu, Sm, Sm, Sm, Uu, Uu^Uf, Sm, Sm, Uu^Uf, Qxu, Qxu, Qxu, Qxu, Xu, Urb^Sr, Xu, Qxu, Xu, Xu, Xu, Uh, Uh, Uu^Uf, Uu, Uu, Uh, Uu, Rp, Qxu, Rb, Rb, Uu, Uh, Uh, Xu, Xu, Xu
Xu, Xu, Xu, Xu, Xu, Uu, Uu^Uf, Sm, Ur, Uu^Ufi, Uu, Uu, Rp, Rp, Sm, Uh, Uh, Qxu, Qxu, Qxu, Qxu, Qxu, Xu, Urb^Sr, Xu, Qxu, Xu, Xu, Rp, Uh, Rb, Uu, Rp, Rp, Uu, Uu, Rp, Uh, Uh, Rp^Vhcr, Uu^Ufi, Uh, Uu^Ufi, Xu, Xu, Xu
Xu, Xu, Xu, Xu, Uu, Uh, Sm, Ur, Xu, Uu, Uu^Uf, Sm, Sm, Rp^Vhcr, Uu, Sm, Xu, Xu, Xu, Qxu, Qxu, Qxu, Qxu, Xu, Qxu, Qxu, Uu, Rp, Uu, Uu, Rb, Uu, Rp, Rp^Vhcr, Uu^Uf, Rp, Xu, Uu^Uf, Uu^Uf, Uu, Uu, Uu, Uu^Uf, Uu^Uf, Xu, Xu
Xu, Xu, Xu, Xu, Ur, Rp^Vhcr, Sm, Xu, Urb^Sr, Xu, Sm, Uh, Rp, Uu, Sm, Uu^Ufi, Xu, Urb^Sr, Xu, Qxu, Qxu, Qxu, Qxu, Qxu, Uh, Uh, Uu, Rp, Xu, Xu, Xu, Uu^Uf, Uu, Uu, Uu^Uf, Xu, Urb^Sr, Xu, Uh, Rp, Rp, Uu^Ii, Rp^Vhcr, Uu^Ii, Xu, Xu
Xu, Urb^Sr, Xu, Xu, Ur, Sm, Uh, Xu, Xu, Xu, Uu, Sm, Rp, Sm, Uh, Uu, Uu, Xu, Qxu, Qxu, Qxu, Qxu, Qxu, Qxu, Uu, Rp, Uu^Uf, Uu^Uf, Xu, Xu, Uh, Rp^Vhcr, Uh, Rp, Rp, Xu, Xu, Xu, Uu^Uf, Uu^Uf, Uu, Uh, Uh, Uu^Ii, Xu, Xu
Xu, Xu, Xu, Uu, Sm, Uu^Uf, Xu, Xu, Xu, Xu, Uh, Sm, Uu, Uu, Xu, Sm, Sm, Qxu, Qxu, Qxu, Qxu, Qxu, Qxu, Ur, Uu, Rp, Uu, Xu, Urb^Sr, Xu, Xu, Uh, Xu, Uu, Qxu, Qxu, Qxu, Qxu, Qxu, Uu^Ufi, Uu, Uh, Uu^Uf, Xu, Xu, Xu
Xu, Xu, Xu, Sm, Sm, Uu, Xu, Urb^Sr, Xu, Uu, Rp^Vhcr, Uu^Ufi, Uu, Xu, Urb^Sr, Xu, Qxu, Qxu, Qxu, Qxu, Xu, Xu, Xu, Uu, Rp, Uh, Xu, Xu, Xu, Xu, Xu, Xu, Urb^Sr, Xu, Qxu, Qxu, Qxu, Qxu, Qxu, Ur, Ur, Uu, Uh, Xu, Xu, Xu
Xu, Xu, Sm, Uh, Ur, Ur, Xu, Xu, Xu, Uu, Rp, Rp, Uh, Xu, Xu, Xu, Qxu, Qxu, Xu, Xu, Xu, Urb^Sr, Xu, Uu^Uf, Rp, Uu, Xu, Xu, Xu, Xu, Xu, Xu, Xu, Xu, Qxu, Qxu, Urb, Urb, Qxu, Uu, Uu, Uh^Ii, Xu, Xu, Xu, Xu
Xu, Xu, Sm, Uu, Sm, Uu^Uf, Xu, Xu, Uh, Uh, Cay, Cay, Cay, Uh, Qxu, Qxu, Qxu, Qxu, Xu, Xu, Uu^Uf, Xu, Uh, Uu^Ufi, Uu, Rp, Xu, Urb^Sr, Xu, Xu, Qxu, Qxu, Qxu, Qxu, Ur, Qxu, Urb, Urb, Urb, Qxu, Qxu, Uh, Xu, Urb^Sr, Xu, Xu
Xu, Xu, Uu, Rp^Vhcr, Sm, Xu, Urb^Sr, Xu, Uu^Uf, Uu, Cay, Kay, Ur, Uu, Qxu, Qxu, Qxu, Xu, Xu, Xu, Uu, Uu^Uf, Uh, Uu, Uu, Rp, Uu, Xu, Xu, Xu, Qxu, Uu^Ii, Uu, Ur, Qxu, Qxu, Urb, Xos, Urb, Urb, Qxu, Qxu, Xu, Xu, Xu, Xu
Xu, Xu, Uu^Uf, Sm, Uu, Xu, Xu, Xu, Xu, Ur, Uu, Uh, Ur, Qxu, Xu, Qxu, Xu, Xu, Xu, Rp^Vhcr, Uu, Uh, Rp, Rp, Rp, Rp, Rp, Uu, Xu, Xu, Xu, Qxu, Uu, Uu, Qxu, Urb, Urb, Urb, Qxu, Urb, Qxu, Xu, Urb^Sr, Xu, Xu, Xu
Xu, Xu, Xu, Ur, Uh, Uu, Xu, Urb^Sr, Xu, Ur, Uu, Uu^Uf, Xu, Xu^Uov, Xu, Xu, Xu, Xu, Xu, Rp, Rp, Uu, Rp, Kay, Uu, Uu^Uf, Uu, Rp, Uu, Xu, Xu, Qxu, Qxu, Uh, Ur, Qxu, Qxu, Qxu, Ur, Qxu, Qxu, Xu, Xu, Xu, Xu, Xu
Xu, Xu, Xu, Ur, Sm, Sm, Uu^Uf, Xu, Uh, Uu^Uf, Sm, Xu, Xu, Xu^Uov, Uu, Xu, Xu, Urb^Sr, Xu, Uu, Kay, Rp, Cay, Rp, Cay, Uu, Kay, Rp, Uu, Xu, Xu, Qxu, Qxu, Uh, Ur, Qxu, Qxu, Qxu, Uh, Uu, Qxu, Xu, Xu, Xu, Xu, Xu
Xu, Xu, Xu, Uu^Uf, Uh, Uu, Sm, Uu, Uh, Sm, Xu, Xu, Xu, Sm, Rp^Vhcr, Uu^Uf, Xu, Xu, Qxu, Qxu, Qxu, Qxu, Cay, Cay, Cay, Ur, Ur, Qxu, Qxu, Xu, Urb^Sr, Xu, Qxu, Qxu, Urb, Urb, Qxu, Qxu, Qxu, Uu^Uf, Uu^Ii, Qxu, Xu, Xu, Xu, Xu
Xu, Urb^Sr, Xu, Xu, Xu, Xu, Xu, Sm, Uu, Sm, Xu, Urb^Sr, Xu, Sm, Uu, Sm, Xu, Xu, Qxu, Qxu, Qxu, Qxu, Qxu, Kay, Cay, Cay, Uu, Qxu, Qxu, Xu, Xu, Xu, Qxu, Qxu, Urb, Urb, Urb, Qxu, Qxu, Uh, Qxu, Qxu, Xu, Urb^Sr, Xu, Xu
Xu, Xu, Xu, Xu, Urb^Sr, Xu, Xu, Uu^Uf, Sm, Uh, Xu, Xu, Xu, Uh, Sm, Uu^Uf, Xu, Xu, Xu, Qxu, Kay, Qxu, Qxu, Cay, Cay, Uu, Kay, Ur, Qxu, Qxu, Xu, Xu, Qxu, Qxu, Urb, Xos, Urb, Urb, Qxu, Qxu, Qxu, Qxu, Qxu, Xu, Xu, Xu
Xu, Xu, Xu, Xu, Xu, Xu, Xu, Uu, Sm, Xu, Urb^Sr, Xu, Urb^Sr, Xu, Uu, Uh, Uu, Xu, Xu, Qxu, Qxu, Qxu, Qxu, Ur, Ur, Uu, Rp, Ur, Qxu, Qxu, Xu, Xu, Qxu, Urb, Urb, Urb, Qxu, Urb, Qxu, Qxu, Qxu, Qxu, Qxu, Xu, Xu, Xu
Xu, Xu, Xu, Xu, Xu, Xu, Sm, Rb, Uu, Xu, Xu, Xu, Xu, Xu, Xu, Sm, Sm, Xu, Xu, Qxu, Qxu, Qxu, Qxu, Kay, Rp, Rp, Uu, Qxu, Qxu, Xu, Urb^Sr, Xu, Qxu, Qxu, Qxu, Qxu, Ur, Qxu, Qxu, Qxu, Qxu, Qxu, Qxu, Xu, Xu, Xu
Xu, Xu, Xu, Xu, Xu, Sm, Rb, Uu^Uf, Xu, Xu, Xu, Xu, Xu, Xu, Xu, Rb, Uh, Xu, Xu, Xu, Xu, Xu, Xu, Rp, Uu^Uf, Rp^Vhcr, Qxu, Qxu, Xu, Xu, Xu, Xu, Qxu, Qxu, Xu, Xu, Uu, Ur, Uh, Xu, Xu, Qxu, Uu^Ii, Xu, Urb^Sr, Xu
Xu, Xu, Xu, Urb^Sr, Xu, Uh, Uu, Rb, Sm, Xu, Xu, Qxu, Qxu, Xu, Xu, Rb, Sm, Sm, Rb, Xu, Qxu, Xu, Xu, Xu, Xu, Uu^Uf, Xu, Xu, Xu, Xu, Qxu, Qxu, Qxu, Qxu, Xu, Xu, Xu, Uu, Uh, Xu, Xu, Ur, Uu, Xu, Xu, Xu
Xu, Xu, Xu, Xu, Uu^Uf, Uh, Rb, Sm, Uu, Xu, Xu, Qxu, Qxu, Xu, Xu, Xu, Xu, Uu, Sm, Rb, Qxu, Qxu, Qxu, Qxu, Qxu, Xu, Xu, Urb^Sr, Xu, Xu, Qxu, Qxu, Uu^Ufi, Xu, Xu, Xu, Rb, Uu, Ur, Xu, Xu, Xu, Uu, Uh, Xu, Xu
Xu, Xu, Xu, Xu, Uu, Sm, Sm, Uu^Uf, Xu, Xu, Qxu, Qxu, Qxu, Qxu, Xu, Urb^Sr, Xu, Uh, Sm, Uu, Uu, Qxu, Cay, Qxu, Qxu, Qxu, Xu, Xu, Xu, Qxu, Qxu, Qxu, Uu, Uu, Uh, Uh, Rb, Uu^Uf, Xu, Xu, Xu, Uu, Ur, Uh, Xu, Xu
Xu, Xu, Xu, Xu, Uh, Cud, Uu, Rb, Xu, Xu, Qxu, Qxu, Qxu, Qxu, Qxu, Xu, Xu, Xu, Uh, Rp^Vhcr, Uu^Uf, Cay, Kay, Cay, Qxu, Xu, Urb^Sr, Xu, Qxu, Qxu, Qxu, Rp^Vhcr, Uu, Rb, Rb, Uu, Uu, Uu^Uf, Rb, Xu, Uu, Ur, Uu^Uf, Uu^Ufi, Xu, Xu
Xu, Xu, Xu, Xu, Xu, Uh, Xu, Xu, Xu, Qxu, Qxu, Qxu, Uu, Qxu, Xu, Xu, Cud, Xu, Xu, Sm, Sm, Cay, Cay, Cay, Qxu, Xu, Xu, Xu, Qxu, Qxu, Xu, Xu, Xu, Xu, Xu, Uu^Ufi, Xu, Uu, Uu^Uf, Uu, Rp^Vhcr, Uh, Uh, Xu, Xu, Xu
Xu, Xu, Xu, Urb^Sr, Xu, Xu, Xu, Xu, Cud, Uu, Rb, Rp^Vhcr, Uh, Cud, Xu, Uu, Uu, Uh, Xu, Rb, Rb, Uu, Sm, Qxu, Qxu, Qxu, Xu, Xu, Qxu, Qxu, Xu, Urb^Sr, Xu, Xu, Urb^Sr, Xu, Xu, Xu, Xu, Uu^Ufi, Rb, Rb, Xu, Xu, Xu, Xu
Xu, Xu, Xu, Xu, Uh, Xu, Uu^Ufi, Xu, Xu, Uu, Uu^Ufi, Uu, Uu, Uu^Uf, Xu, Rb, Rb, Uu^Ufi, Ur, Xu, Xu, Uu^Uf, Uu, Sm, Sm, Uu^Uf, Sm, Qxu, Qxu, Qxu, Uu, Xu, Uu^Ufi, Xu, Xu, Xu, Uu^Ufi, Xu, Uu, Uu, Uh, Uu, Xu, Urb^Sr, Xu, Xu
Xu, Xu, Xu, Uh, Uu, Uu, Uu, Cud, Xu, Xu, Xu, Xu, Xu, Xu, Rp^Vhcr, Xu, Uh, Uu, Xu, Xu, Xu, Xu, Sm, Rp, Sm, Rp^Vhcr, Rp, Qxu, Qxu^Bh/, Rb, Rb, Uu, Ur, Ur, Uu, Uu^Uf, Uh, Rb, Rb, Uh, Uu, Rp, Rp, Xu, Xu, Xu
Xu, Xu, Xu, Cud, Uu^Ufi, Rb, Rb, Uh, Xu, Urb^Sr, Xu, Xu, Xu, Rb, Uh, Xu, Xu, Cud, Xu, Cud, Uh, Xu, Xu, Rp, Uh, Sm, Rp, Qxu^Bh/, Qxu, Xu, Xu, Uu^Uf, Xu, Uu, Uh, Uu, Xu, Uu, Xu, Xu, Xu, Uu^Uf, Uh, Xu, Xu, Xu
Xu, Xu, Xu, Xu, Xu, Xu, Xu, Xu, Xu, Xu, Cud, Uu, Uu, Uu, Uu^Uf, Cud, Xu, Xu, Uu^Ufi, Uu, Uu, Uh, Xu, Sm, Uh, Uu, Qxu, Qxu, Qxu, Xu, Xu, Xu, Urb^Sr, Xu, Ur, Rp, Xu, Xu, Urb^Sr, Xu, Ur, Rp, Uh, Xu, Urb^Sr, Xu
Xu, Xu, Xu, Xu, Cud, Xu, Xu, Xu, Urb^Sr, Xu, Xu, Uh, Rb, Rb, Xu, Xu, Uu^Uf, Xu, Xu, Rb, Xu, Cud, Xu, Uu, Sm, Rp, Qxu^Bh\, Qxu, Qxu, Qxu, Uu^Uf, Xu, Xu, Xu, Ur, Uh, Ur, Xu, Xu, Xu, Uu, Rp^Vhcr, Uu^Uf, Xu, Xu, Xu
Xu, Xu, Xu, Uu, Rb, Rb, Uu^Ufi, Xu, Xu, Xu, Xu, Uu^Uf, Uu^Ufi, Uh, Xu, Rb, Uh, Cud, Xu, Rb^Ii, Xu, Xu, Xu, Sm, Uh, Rp, Qxu, Qxu^Bh\, Qxu^Bh\, Uu^Uf, Rp, Uh, Xu^Uov, Xu^Uov, Xu, Uh, Rp, Xu, Uh, Uh, Cay, Uu^Uf, Rp, Uu, Xu, Xu
Xu, Xu, Xu, Uu, Uh, Uh, Uu^Uf, Xu, Rb, Cud, Uu^Uf, Xu, Xu, Xu, Uu^Ufi, Uu, Uu, Xu, Cud, Xu, Sm, Xu, Uu, Rb, Sm, Qxu, Qxu, Qxu, Qxu, Rp, Uu, Xu, Xu, Xu, Xu, Uu, Uu, Uu^Uf, Uu, Cay, Kay, Cay, Rp, Uu, Xu, Xu
Xu, Xu, Urb^Sr, Xu, Uu, Rb, Xu, Xu, Rb, Uh, Uu, Xu, Xu, Uh, Rb, Rb, Xu, Xu, Uu, Uu, Sm, Sm, Uh, Rb, Qxu, Qxu, Qxu, Qxu, Xu, Uh, Rp, Uu^Uf, Xu, Urb^Sr, Xu, Xu, Rp, Rp^Vhcr, Uu, Cay, Cay, Cay, Uh, Uu^Uf, Xu, Xu
Xu, Xu, Xu, Xu, Xu, Cud, Xu, Uu, Uu, Uh, Xu, Xu, Xu, Cud, Uu, Uh, Xu, Sm, Sm, Rp^Vhcr, Rb, Uh, Uu^Uf, Sm, Qxu, Qxu, Qxu, Qxu, Xu, Xu, Ur, Uh, Rp, Xu, Rp, Xu, Uu, Rp, Uh, Urb, Urb, Uh, Uh, Uu^Uf, Xu, Xu
Xu, Xu, Xu, Xu, Xu, Xu, Xu, Cud, Xu, Xu, Xu, Urb^Sr, Xu, Xu, Xu, Xu, Xu, Uu^Uf, Uh, Rb, Xu, Xu, Xu, Qxu, Qxu, Qxu, Qxu, Xu, Xu, Xu, Xu, Uh, Urb, Uu^Uf, Uu, Rp, Uu^Uf, Uh, Uu^Uf, Uu, Xu, Uu, Xu, Xu, Xu, Xu
Xu, Xu, Xu, Xu, Xu, Xu, Urb^Sr, Xu, Xu, Xu, Xu, Xu, Xu, Xu, Xu, Urb^Sr, Xu, Xu, Xu, Xu, Xu, Urb^Sr, Xu, Qxu, Qxu, Qxu, Qxu, Xu, Xu, Urb^Sr, Xu, Xu, Xu, Uh, Xu, Rp, Xu, Xu, Xu, Xu, Urb^Sr, Xu, Xu, Urb^Sr, Xu, Xu
Xu, Xu, Xu, Xu, Xu, Xu, Xu, Xu, Xu, Xu, Xu, Xu, Xu, Xu, Xu, Xu, Xu, Xu, Xu, Xu, Xu, Xu, Qxu, Qxu, Qxu, Qxu, Qxu, Qxu, Xu, Xu, Xu, Xu, Xu, Xu, Xu, Xu, Xu, Xu, Xu, Xu, Xu, Xu, Xu, Xu, Xu, Xu
