Xu, Xu, Xu, Xu, Xu, Xu, Xu, Xu, Xu, Xu, Xu, Xu, Xu, Xu, Xu, Xu, Xu, Xu, Xu, Xu, Xu, Xu, Xu, Xu, Xu, Xu, Xu, Xu, Xu, Xu, Xu, Xu, Xu, Xu, Xu, Xu, Xu, Xu, Xu, Xu, Xu, Xu, Xu, Xu, Xu, Xu
Xu, Xu, Urb^Sr, Xu, Xu, Xu, Xu, Xu, Xu, Xu, Xu, Xu, Xu, Xu, Xu, Xu, Urb^Sr, Xu, Xu, Xu, Xu, Xu, Xu, Xu, Urb^Sr, Xu, Urb^Sr, Xu, Xu, Xu, Xu, Xu, Xu, Xu, Xu, Xu, Xu, Xu, Xu, Xu, Xu, Xu, Urb^Sr, Xu, Xu, Xu
Xu, Xu, Xu, Xu, Uh, Xu, Uu, Uu, Tb^Tfi, Xu, Urb^Sr, Xu, Xu, Tb^Tf, Uh, Xu, Xu, Xu, Qxu, Qxu, Qxu, Qxu, Qxu, Xu, Xu, Xu, Xu, Xu, Qxu, Qxu, Qxu, Xu, Xu, Urb^Sr, Xu, Xu, Qxu, Xu, Uu, Tb^Tf, Tb^Tf, Xu, Xu, Xu, Xu, Xu
Xu, Xu, Xu, Tb^Tf, Uh^Ecf, Uh, Ce, Tb^Tfi, Uu, Xu, Xu, Xu, Sm, Uh, Uu, Xu, Xu, Qxu, Qxu, Qxu, Qxu, Qxu, Qxu, Qxu, Xu, Urb^Sr, Xu, Qxu, Qxu, Qxu, Xu, Xu, Xu, Xu, Qxu, Qxu, Urb, Qxu, Uu, Cud^Ii, Ur, Uh, Xu, Urb^Sr, Xu, Xu
Xu, Urb^Sr, Xu, Uu, Tb^Tf, Ce, 1 Ke, Ce, Tb^Tf, Uu, Ur, Uh, Sm, Rp, Rp^Vhcr, Uu, Uh, Qxu, Qxu, Qxu, Xu, Xu, Xu, Qxu, Qxu, Xu, Urb^Sr, Xu, Qxu, Qxu, Xu, Urb^Sr, Xu, Qxu, Qxu, Urb, Urb, Qxu, Qxu, Ur, Qxu, Uh, Xu, Xu, Xu, Xu
Xu, Xu, Xu, Uu, Uh, Ce, Ce, Ce, Rb, Uh, Ur, Uu, Uu, Rp, Sm, Sm, Tb^Tf, Rp, Qxu, Qxu, Xu, Urb^Sr, Urb^Sr, Xu, Qxu, Xu, Xu, Xu, Rp^Vhcr, Uu, Uh, Xu, Qxu, Qxu, Qxu, Urb, Uu^Xo, Urb, Urb, Qxu, Qxu, Qxu, Xu, Urb^Sr, Xu, Xu
Xu, Xu, Urb^Sr, Xu, Uu, Uh, Tb^Tf, Uh, Rb, Uh, Uh, Ur, Sm, Tb^Tfi, Uu, Sm, Xu, Xu, Xu, Qxu, Qxu, Xu, Xu, Xu, Qxu, Qxu, Qxu, Qxu, Xu, Rp, Uh, Uu, Uu, Qxu, Urb, Urb, Urb, Urb, Urb, Qxu, Qxu, Qxu, Xu, Xu, Xu, Xu
Xu, Xu, Xu, Xu, Xu, Tb^Tf, Xu, Xu, Xu, Uu, Xu, Xu, Tb^Tf, Sm, Rp, Uh, Xu, Urb^Sr, Xu, Qxu, Qxu, Qxu, Qxu, Qxu, Qxu, Qxu, Qxu, Qxu, Xu, Xu, Uu, Rp, Uu, Qxu, Qxu, Urb, Qxu, Qxu, Qxu, Qxu, Qxu, Xu, Urb^Sr, Xu, Xu, Xu
Xu, Xu, Xu, Xu, Urb^Sr, Xu, Xu, Xu, Xu, Xu, Xu, Xu, Uu, Sm, Rp, Uh, Sm, Xu, Qxu, Qxu, Qxu, Qxu, Xu, Xu, Xu, Qxu, Qxu, Xu, Xu, Xu, Tb^Tf, Rp, Rp, Tb^Tf, Uh, Qxu, Qxu, Qxu, Qxu, Qxu, Qxu, Xu, Xu, Xu, Xu, Xu
Xu, Xu, Xu, Xu, Xu, Xu, Sm, Sm, Uu, Xu, Sm, Sm, Sm, Uu, Tb^Tf, Sm, Sm, Tb^Tf, Qxu, Qxu, Qxu, Qxu, Xu, Urb^Sr, Xu, Qxu, Xu, Xu, Xu, Uh, Uh, Tb^Tf, Uu, Uu, Uh, Uu, Rp, Qxu, Rb, Rb, Uu, Uh, Uh, Xu, Xu, Xu
Xu, Xu, Xu, Xu, Xu, Uu, Tb^Tf, Sm, Ur, Tb^Tfi, Uu, Uu, Rp, Rp, Sm, Uh, Uh, Qxu, Qxu, Qxu, Qxu, Qxu, Xu, Urb^Sr, Xu, Qxu, Xu, Xu, Rp, Uh, Rb, Uu, Rp, Rp, Uu, Uu, Rp, Uh, Uh, Rp^Vhcr, Tb^Tfi, Uh, Tb^Tfi, Xu, Xu, Xu
Xu, Xu, Xu, Xu, Uu, Uh, Sm, Ur, Xu, Uu, Tb^Tf, Sm, Sm, Rp^Vhcr, Uu, Sm, Xu, Xu, Xu, Qxu, Qxu, Qxu, Qxu, Xu, Qxu, Qxu, Uu, Rp, Uu, Uu, Rb, Uu, Rp, Rp^Vhcr, Tb^Tf, Rp, Xu, Tb^Tf, Tb^Tf, Uu, Uu, Uu, Tb^Tf, Tb^Tf, Xu, Xu
Xu, Xu, Xu, Xu, Ur, Rp^Vhcr, Sm, Xu, Urb^Sr, Xu, Sm, Uh, Rp, Uu, Sm, Tb^Tfi, Xu, Urb^Sr, Xu, Qxu, Qxu, Qxu, Qxu, Qxu, Uh, Uh, Uu, Rp, Xu, Xu, Xu, Tb^Tf, Uu, Uu, Tb^Tf, Xu, Urb^Sr, Xu, Uh, Rp, Rp, Uu^Ii, Rp^Vhcr, Uu^Ii, Xu, Xu
Xu, Urb^Sr, Xu, Xu, Ur, Sm, Uh, Xu, Xu, Xu, Uu, Sm, Rp, Sm, Uh, Uu, Uu, Xu, Qxu, Qxu, Qxu, Qxu, Qxu, Qxu, Uu, Rp, Tb^Tf, Tb^Tf, Xu, Xu, Uh, Rp^Vhcr, Uh, Rp, Rp, Xu, Xu, Xu, Tb^Tf, Tb^Tf, Uu, Uh, Uh, Uu^Ii, Xu, Xu
Xu, Xu, Xu, Uu, Sm, Tb^Tf, Xu, Xu, Xu, Xu, Uh, Sm, Uu, Uu, Xu, Sm, Sm, Qxu, Qxu, Qxu, Qxu, Qxu, Qxu, Ur, Uu, Rp, Uu, Xu, Urb^Sr, Xu, Xu, Uh, Xu, Uu, Qxu, Qxu, Qxu, Qxu, Qxu, Tb^Tfi, Uu, Uh, Tb^Tf, Xu, Xu, Xu
Xu, Xu, Xu, Sm, Sm, Uu, Xu, Urb^Sr, Xu, Uu, Rp^Vhcr, Tb^Tfi, Uu, Xu, Urb^Sr, Xu, Qxu, Qxu, Qxu, Qxu, Xu, Xu, Xu, Uu, Rp, Uh, Xu, Xu, Xu, Xu, Xu, Xu, Urb^Sr, Xu, Qxu, Qxu, Qxu, Qxu, Qxu, Ur, Ur, Uu, Uh, Xu, Xu, Xu
Xu, Xu, Sm, Uh, Ur, Ur, Xu, Xu, Xu, Uu, Rp, Rp, Uh, Xu, Xu, Xu, Qxu, Qxu, Xu, Xu, Xu, Urb^Sr, Xu, Tb^Tf, Rp, Uu, Xu, Xu, Xu, Xu, Xu, Xu, Xu, Xu, Qxu, Qxu, Urb, Urb, Qxu, Uu, Uu, Uh^Ii, Xu, Xu, Xu, Xu
Xu, Xu, Sm, Uu, Sm, Tb^Tf, Xu, Xu, Uh, Uh, Cay, Cay, Cay, Uh, Qxu, Qxu, Qxu, Qxu, Xu, Xu, Tb^Tf, Xu, Uh, Tb^Tfi, Uu, Rp, Xu, Urb^Sr, Xu, Xu, Qxu, Qxu, Qxu, Qxu, Ur, Qxu, Urb, Urb, Urb, Qxu, Qxu, Uh, Xu, Urb^Sr, Xu, Xu
Xu, Xu, Uu, Rp^Vhcr, Sm, Xu, Urb^Sr, Xu, Tb^Tf, Uu, Cay, 3 Kay, Ur, Uu, Qxu, Qxu, Qxu, Xu, Xu, Xu, Uu, Tb^Tf, Uh, Uu, Uu, Rp, Uu, Xu, Xu, Xu, Qxu, Uu^Ii, Uu, Ur, Qxu, Qxu, Urb, Uu^Xo, Urb, Urb, Qxu, Qxu, Xu, Xu, Xu, Xu
Xu, Xu, Tb^Tf, Sm, Uu, Xu, Xu, Xu, Xu, Ur, Uu, Uh, Ur, Qxu, Xu, Qxu, Xu, Xu, Xu, Rp^Vhcr, Uu, Uh, Rp, Rp, Rp, Rp, Rp, Uu, Xu, Xu, Xu, Qxu, Uu, Uu, Qxu, Urb, Urb, Urb, Qxu, Urb, Qxu, Xu, Urb^Sr, Xu, Xu, Xu
Xu, Xu, Xu, Ur, Uh, Uu, Xu, Urb^Sr, Xu, Ur, Uu, Tb^Tf, Xu^Uov, Xu^Uov, Xu^Uov, Xu, Xu, Xu, Xu, Rp, Rp, Uu, Rp, Kay, Uu, Tb^Tf, Uu, Rp, Uu, Xu, Xu, Qxu, Qxu, Uh, Ur, Qxu, Qxu, Qxu, Ur, Qxu, Qxu, Xu, Xu, Xu, Xu, Xu
Xu, Xu, Xu, Ur, Sm, Sm, Tb^Tf, Xu, Uh, Tb^Tf, Sm, Xu^Uov, Xu^Uov, Xu^Uov, Uu, Uh, Xu, Urb^Sr, Xu, Uu, Kay, Rp, Cay, Rp, Cay, Uu, Kay, Rp, Uu, Xu, Xu, Qxu, Qxu, Uh, Ur, Qxu, Qxu, Uu, Uh, Uu, Qxu, Xu, Xu, Xu, Xu, Xu
Xu, Xu, Xu, Tb^Tf, Uh, Uu, Sm, Uu, Uh, Sm, Xu, Xu, Xu, Sm, Rp^Vhcr, Tb^Tf, Xu, Xu, Qxu, Qxu, Qxu, Qxu, Cay, Cay, Cay, Ur, Ur, Qxu, Qxu, Xu, Urb^Sr, Xu, Qxu, Qxu, Urb, Urb, Qxu, Qxu, Ur, Tb^Tf, Uu^Ii, Qxu, Xu, Xu, Xu, Xu
Xu, Urb^Sr, Xu, Xu, Xu, Xu, Xu, Sm, Uu, Sm, Xu, Urb^Sr, Xu, Sm, Uu, Sm, Uh, Xu, Qxu, Qxu, Qxu, Qxu, Qxu, 2 Kay, Cay, Cay, Uu, Qxu, Qxu, Xu, Xu, Xu, Qxu, Qxu, Urb, Urb, Urb, Qxu, Uu, Uh, Ur, Qxu, Xu, Urb^Sr, Xu, Xu
Xu, Xu, Xu, Xu, Urb^Sr, Xu, Xu, Tb^Tf, Sm, Uh, Xu, Xu, Xu, Uh, Sm, Tb^Tf, Uh, Xu, Xu, Qxu, Kay, Qxu, Qxu, Cay, Cay, Uu, Kay, Ur, Qxu, Qxu, Xu, Xu, Qxu, Qxu, Urb, Uu^Xo, Urb, Urb, Qxu, Uu, Qxu, Qxu, Qxu, Xu, Xu, Xu
Xu, Xu, Xu, Xu, Xu, Xu, Xu, Uu, Sm, Xu, Urb^Sr, Xu, Urb^Sr, Xu, Uu, Uh, Uu, Xu, Xu, Qxu, Qxu, Qxu, Qxu, Ur, Ur, Uu, Rp, Ur, Qxu, Qxu, Xu, Xu, Qxu, Urb, Urb, Urb, Qxu, Urb, Qxu, Qxu, Qxu, Qxu, Qxu, Xu, Xu, Xu
Xu, Xu, Xu, Xu, Xu, Xu, Sm, Rb, Uu, Xu, Xu, Xu, Xu, Xu, Uh, Sm, Sm, Xu, Xu, Qxu, Qxu, Qxu, Qxu, Kay, Rp, Rp, Uu, Qxu, Qxu, Xu, Urb^Sr, Xu, Qxu, Qxu, Qxu, Qxu, Ur, Qxu, Qxu, Qxu, Qxu, Qxu, Qxu, Xu, Xu, Xu
Xu, Xu, Xu, Xu, Xu, Sm, Rb, Tb^Tf, Xu, Xu, Xu, Xu, Xu, Xu, Uh, Rb, Uh, Uu, Uu, Xu, Xu, Xu, Xu, Rp, Tb^Tf, Rp^Vhcr, Qxu, Qxu, Xu, Xu, Xu, Xu, Qxu, Qxu, Xu, Xu, Uu, Ur, Uh, Xu, Xu, Qxu, Uu^Ii, Xu, Urb^Sr, Xu
Xu, Xu, Xu, Urb^Sr, Xu, Uh, Uu, Rb, Sm, Xu, Xu, Qxu, Qxu, Xu, Xu, Rb, Sm, Sm, Rb, Uu, Qxu, Xu, Xu, Xu, Xu, Tb^Tf, Xu, Xu, Xu, Xu, Qxu, Qxu, Qxu, Qxu, Xu, Xu, Xu, Uu, Uh, Xu, Xu^Uov, Ur, Uu, Xu, Xu, Xu
Xu, Xu, Xu, Xu, Tb^Tf, Uh, Rb, Sm, Uu, Xu, Xu, Qxu, Qxu, Xu, Xu, Xu, Xu, Uu, Sm, Rb, Qxu, Qxu, Qxu, Qxu, Qxu, Xu, Xu, Urb^Sr, Xu, Xu, Qxu, Qxu, Tb^Tfi, Xu, Xu, Xu, Rb, Uu, Ur, Xu^Uov, Xu, Xu, Uu, Uh, Xu, Xu
Xu, Xu, Xu, Xu, Uu, Sm, Sm, Tb^Tf, Xu, Xu, Qxu, Qxu, Cud, Qxu, Xu, Urb^Sr, Xu, Uh, Sm, Uu, Uu, Qxu, Cay, Qxu, Qxu, Qxu, Xu, Xu, Xu, Qxu, Qxu, Qxu, Uu, Uu, Uh, Uh, Rb, Tb^Tf, Xu, Xu, Xu, Uu, Ur, Uh, Xu, Xu
Xu, Xu, Xu, Xu, Uh, Cud, Uu, Rb, Xu, Xu, Qxu, Cud, Cud, Qxu, Qxu, Xu, Xu, Xu, Uh, Rp^Vhcr, Tb^Tf, Cay, 4 Kay, Cay, Qxu, Xu, Urb^Sr, Xu, Qxu, Qxu, Qxu, Rp^Vhcr, Uu, Rb, Rb, Uu, Uu, Tb^Tf, Rb, Xu, Uu, Ur, Tb^Tf, Tb^Tfi, Xu, Xu
Xu, Xu, Xu, Xu, Xu, Uh, Xu, Xu, Xu, Qxu, Cud, 7 Kud, Uu, Qxu, Xu, Xu, Cud, Xu, Xu, Ur, Ur, Cay, Cay, Cay, Qxu, Xu, Xu, Xu, Qxu, Qxu, Xu, Xu, Xu, Xu, Xu, Tb^Tfi, Xu, Uu, Tb^Tf, Uu, Rp^Vhcr, Uh, Uh, Xu, Xu, Xu
Xu, Xu, Xu, Urb^Sr, Xu, Xu, Xu, Xu, Cud, Uu, Rb, Rp^Vhcr, Uh, Cud, Xu, Uu, Uu, Uh, Xu, Rb, Rb, Uu, Sm, Qxu, Qxu, Qxu, Xu, Xu, Qxu, Qxu, Xu, Urb^Sr, Xu, Xu, Urb^Sr, Xu, Xu, Xu, Xu, Tb^Tfi, Rb, Rb, Xu, Xu, Xu, Xu
Xu, Xu, Xu, Xu, Uh, Xu, Tb^Tfi, Xu, Xu, Uu, Tb^Tfi, Uu, Uu, Tb^Tf, Xu, Rb, Rb, Tb^Tfi, Ur, Xu, Xu, Tb^Tf, Uu, Sm, Ur, Tb^Tf, Sm, Qxu, Qxu, Qxu, Uu, Xu, Tb^Tfi, Xu, Xu, Xu, Tb^Tfi, Xu, Uu, Uu, Uh, Uu, Xu, Urb^Sr, Xu, Xu
Xu, Xu, Xu, Uh, Uu, Uu, Uu, Cud, Xu, Xu, Xu, Xu, Xu, Xu, Rp^Vhcr, Xu, Uh, Uu, Xu, Xu, Xu, Xu, Sm, Rp, Ur, Rp^Vhcr, Rp, Qxu, Qxu^Bcx/, Rb, Rb, Uu, Ur, Ur, Uu, Tb^Tf, Uh, Rb, Rb, Uh, Uu, Rp, Rp, Xu, Xu, Xu
Xu, Xu, Xu, Cud, Tb^Tfi, Rb, Rb, Uh, Xu, Urb^Sr, Xu, Xu, Xu, Rb, Uh, Xu, Xu, Cud, Xu, Cud, Uh, Xu, Xu, Rp, Uh, Ur, Rp, Qxu^Bcx/, Qxu, Xu, Xu, Tb^Tf, Xu, Uu, Uh, Uu, Xu, Uu, Xu, Xu, Xu, Tb^Tf, Uh, Xu, Xu, Xu
Xu, Xu, Xu, Xu, Xu, Xu, Xu, Xu, Xu, Xu, Cud, Uu, Uu, Uu, Tb^Tf, Cud, Xu, Xu, Tb^Tfi, Uu, Uu, Uh, Xu, Sm, Uh, Uu, Qxu^Bcx\, Qxu, Qxu, Xu, Xu, Xu, Urb^Sr, Xu, Ur, Rp, Xu, Xu, Urb^Sr, Xu, Ur, Rp, Uh, Xu, Urb^Sr, Xu
Xu, Xu, Xu, Xu, Cud, Xu, Xu, Xu, Urb^Sr, Xu, Xu, Uh, Rb, Rb, Xu, Xu, Tb^Tf, Xu, Xu, Rb, Xu, Cud, Xu, Uu, Sm, Rp, Qxu^Bcx\, Qxu^Bcx\, Qxu^Bcx\, Qxu, Tb^Tf, Xu, Xu, Xu, Ur, Uh, Ur, Xu, Xu, Xu, Uu, Rp^Vhcr, Tb^Tf, Xu, Xu, Xu
Xu, Xu, Xu, Uu, Rb, Rb, Tb^Tfi, Xu, Xu, Xu, Xu, Tb^Tf, Tb^Tfi, Uh, Xu, Rb, Uh, Cud, Xu, Rb^Ii, Xu, Xu, Xu, Sm, Uh, Rp, Qxu, Qxu^Bcx\, Qxu^Bcx\, Ur, Rp, Uh, Xu^Uov, Xu^Uov, Xu, Uh, Rp, Xu, Uh, Uh, Cay, Tb^Tf, Rp, Uu, Xu, Xu
Xu, Xu, Xu, Uu, Uh, Uh, Tb^Tf, Xu, Rb, Cud, Tb^Tf, Xu, Xu, Xu, Tb^Tfi, Uu, Uu, Xu, Cud, Xu, Ur, Xu, Uu, Rb, Sm, Qxu, Qxu, Qxu, Qxu, Rp, Uu, Xu^Uov, Xu, Xu, Xu, Uu, Uu, Tb^Tf, Uu, Cay, 5 Kay, Cay, Rp, Uu, Xu, Xu
Xu, Xu, Urb^Sr, Xu, Uu, Rb, Xu, Xu, Rb, Uh, Uu, Xu, Xu, Uh, Rb, Rb, Xu, Xu, Uu, Uu, Sm, Sm, Uh, Rb, Qxu, Qxu, Qxu, Qxu, Xu, Uh, Rp, Tb^Tf, Xu, Urb^Sr, Xu, Xu, Rp, Rp^Vhcr, Uu, Cay, Cay, Cay, Uh, Tb^Tf, Xu, Xu
Xu, Xu, Xu, Xu, Xu, Cud, Xu, Uu, Uu, Uh, Xu, Xu, Xu, Cud, Uu, Uh, Xu, Sm, Sm, Rp^Vhcr, Rb, Uh, Tb^Tf, Sm, Qxu, Qxu, Qxu, Qxu, Xu, Xu, Ur, Uh, Rp, Xu, Rp, Xu, Uu, Rp, Uh, Urb, Urb, Uh, Uh, Tb^Tf, Xu, Xu
Xu, Xu, Xu, Xu, Xu, Xu, Xu, Cud, Xu, Xu, Xu, Urb^Sr, Xu, Xu, Xu, Xu, Xu, Tb^Tf, Uh, Rb, Xu, Xu, Xu, Qxu, Qxu, Qxu, Qxu, Xu, Xu, Xu, Xu, Uh, Urb, Tb^Tf, Uu, Rp, Tb^Tf, Uh, Tb^Tf, Uu, Xu, Uu, Xu, Xu, Xu, Xu
Xu, Xu, Xu, Xu, Xu, Xu, Urb^Sr, Xu, Xu, Xu, Xu, Xu, Xu, Xu, Xu, Urb^Sr, Xu, Xu, Xu, Xu, Xu, Urb^Sr, Xu, Qxu, Qxu, Qxu, Qxu, Xu, Xu, Urb^Sr, Xu, Xu, Xu, Uh, Xu, Rp, Xu, Xu, Xu, Xu, Urb^Sr, Xu, Xu, Urb^Sr, Xu, Xu
Xu, Xu, Xu, Xu, Xu, Xu, Xu, Xu, Xu, Xu, Xu, Xu, Xu, Xu, Xu, Xu, Xu, Xu, Xu, Xu, Xu, Xu, Qxu, Qxu, Qxu, Qxu, Qxu, Qxu, Xu, Xu, Xu, Xu, Xu, Xu, Xu, Xu, Xu, Xu, Xu, Xu, Xu, Xu, Xu, Xu, Xu, Xu
