border_size=1
usage=map

Xu, Xu, Xu, Xu, Xu, Xu, Xu, Xu, Xu, Xu, Xu, Xu, Xu, Xu, Xu, Xu, Xu, Xu, Xu, Xu, Xu, Xu, Xu, Xu, Xu, Xu, Xu, Xu, Xu, Xu, Xu, Xu, Xu, Xu, Xu, Xu, Xu, Xu, Xu, Xu, Xu, Xu, Xu, Xu, Xu, Xu
Xu, Xu, Xu, Xu, Xu, Xu, Xu, Xu, Xu, Xu, Xu, Xu, Xu, Xu, Xu, Xu, Xu, Xu, Xu, Xu, Xu, Xu, Xu, Xu, Xu, Xu, Xu, Xu, Xu, Xu, Xu, Xu, Xu, Xu, Xu, Xu, Xos, Xu, Cud^Sr, Xu, Xu, Xu, Xu, Xu, Xu, Xu
Xu, Xu, Xu, Xu, Xu, Xu, Xu, Xu, Xu, Xu, Xu, Xu, Xu, Xu, Xu, Xu, Xu, Xu, Xu, Xu, Xu, Xu, Xu, Xu, Xos, Xu, Xos, Xu, Xu, Xu, Xu, Xu, Xu, Cud^Sr, Xos, Xos, Qxu, Xos, Xos, Xos, Xos, Xu, Xu, Xu, Xu, Xu
Xu, Xu, Xu, Xu, Xu, Xu, Xu, Xu, Xu, Xu, Xu, Xu, Xu, Xu, Cud^Sr, Xu, Xu, Xu, Xu, Xu, Xu, Cud^Sr, Xos, Xos, Qxu, Qxu, Qxu, Xos, Xos, Cud^Sr, Xos, Xos, Sm, Xos, Qxu, Qxu, Qxu, Qxu, Qxu, Qxu, Qxu, Xos, Xos, Xu, Xu, Xu
Xu, Xu, Xu, Xu, Xu, Xu, Xu, Xu, Xu, Xu, Xu, Xu, Xu, Xu, Xos, Xu, Xu, Xu, Xu, Xu, Xos, Xos, Qxu, Qxu, Qxu, Qxu, Qxu, Qxu, Qxu, Xos, Sm, Sm, Rb, Sm, Rb, Qxu, Cay^Sr, Cay^Sr, Cay^Sr, Qxu, Qxu, Qxu, Xos, Cud^Sr, Xu, Xu
Xu, Xu, Xu, Xu, Xu, Xu, Xu, Xu, Xu, Xu, Xu, Cud^Sr, Xos, Xos, Wog, Xos, Xos, Cud^Sr, Xos, Xos, Xuc, Xuc, Xuc, Qxu, Qxu, Qxu, Xuc, Qxu, Qxu, Rb, Sm, Sm, Xuc, Rb, Sm, Sm, Cay^Sr, Cay^Sc, Cay^Sr, Qxu, Qxu, Qxu, Xu, Xu, Xu, Xu
Xu, Xu, Xu, Xu, Xu, Xu, Xu, Xu, Xu, Xu, Xos, Xos, Wog, Wog, Wwg, Wog, Wog, Xos, Wog, Wog, Xuc, Cud^Sr, Xuc, Qxu, Qxu, Xuc, Cud^Sr, Xuc, Sm, Rb, Sm, Xuc, Cud^Sr, Xuc, Sm, Sm, Sm, Cay^Sr, Sm, Qxu, Qxu, Xos, Xu, Xu, Xu, Xu
Xu, Xu, Xu, Xu, Xu, Xu, Xu, Xu, Xu, Xos, Xos, Wog, Wog, Wwg, Cay^Sr, Wog, Wog, Wog, Wog, Wog, Uh, Xuc, Sm, Sm, Sm, Xuc, Xuc, Xuc, Sm, Sm, Sm, Xuc, Xuc, Xuc, Rb, Rb, Sm, Sm, Qxu, Qxu, Xos, Xos, Xu, Xu, Xu, Xu
Xu, Xu, Xu, Xu, Xu, Xu, Xu, Xu, Xu, Xos, Xos, Wog, Wwg, Cay^Sr, Kay, Cay^Sr, Wwg, Wog, Wog, Uh, Uu^Uf, Uu, Sm, Rb, Rb, Sm, Sm, Sm, Rb, Sm, Sm, Rb, Sm, Sm, Rb, Sm, Xuc, Qxu, Qxu, Qxu, Xos, Cud^Sr, Xu, Xu, Xu, Xu
Xu, Xu, Xu, Xu, Xu, Xu, Xu, Xu, Xu, Xos, Xos, Wwg, Wwg, Cay^Sr, Cay^Sr, Cay^Sr, Wwg, Wog, Wwg, Uu, Uh, Uu, Rb, Sm, Xuc, Sm, Sm, Rb, Sm, Sm, Xuc, Rb, Rb, Sm, Sm, Xuc, Cud^Sr, Xuc, Qxu, Xos, Xu, Xu, Xu, Xu, Xu, Xu
Xu, Xu, Xu, Xu, Xu, Xu, Xu, Xu, Xu, Xu, Cud^Sr, Xos, Wog, Wog, Wog, Wwg, Wog, Wwg, Uh, Rb, Uh, Uu^Uf, Uu^Uf, Xuc, Cud^Sr, Xuc, Sm, Rb, Sm, Xuc, Cud^Sr, Xuc, Sm, Sm, Sm, Xuc, Xuc, Xuc, Qxu, Xos, Xu, Xu, Xu, Xu, Xu, Xu
Xu, Xu, Xu, Xu, Xu, Xu, Xu, Xu, Xu, Xu, Xu, Xu, Xos, Wog, Wog, Wwg, Wog, Wog, Uu, Rb, Rb, Uu, Uu, Xuc, Xuc, Xuc, Qxu, Sm, Sm, Xuc, Xuc, Xuc, Rb, Sm, Xuc, Qxu, Qxu, Qxu, Xos, Xu, Cud^Sr, Xu, Xu, Xu, Xu, Xu
Xu, Xu, Xu, Xu, Xu, Xu, Xu, Xu, Xu, Xu, Xu, Xu, Xos, Wog, Uh, Uh, Rb, Uu, Uu^Uf, Uu^Uf, Uu, Uh, Uh, Qxu, Qxu, Qxu, Sm, Sm, Rb, Sm, Sm, Sm, Rb, Xuc, Cud^Sr, Xuc, Qxu, Qxu, Xos, Xu, Xu, Xu, Xu, Xu, Xu, Xu
Xu, Xu, Xu, Xu, Xu, Xu, Xu, Cud^Sr, Xos, Xu, Xos, Xos, Xu, Uu, Uu, Rb, Uu, Rb, Qxu, Qxu, Qxu, Uu, Rb, Rb, Qxu, Qxu, Sm, Rb, Sm, Sm, Sm, Rb, Sm, Xuc, Xuc, Xuc, Xos, Xos, Xu, Xu, Xu, Xu, Xu, Xu, Xu, Xu
Xu, Xu, Xu, Xu, Xu, Xu, Xu, Xos, Uh, Uh, Uu, Cud, Xu, Xu, Uh, Uh, Uu^Uf, Qxu, Qxu, Qxu, Qxu, Uu, Cay^Sr, Uu^Uf, Qxu, Qxu, Qxu, Sm, Xos, Xos, Xos, Sm, Xos, Xos, Xos, Xos, Cud^Sr, Xu, Xu, Xu, Xu, Xu, Xu, Xu, Xu, Xu
Xu, Xu, Xu, Xu, Xu, Xu, Xu, Xos, Rb, Uu^Uf, Uu^Uf, Cud, Cud, Xu, Xos, Uu^Uf, Qxu, Qxu, Qxu, Qxu, Uu, Cay^Sr, Kay, Cay^Sr, Qxu, Qxu, Qxu, Xos, Xu, Cud^Sr, Xu, Xos, Xu, Xu, Xu, Xu, Xu, Xu, Xu, Xu, Xu, Xu, Xu, Xu, Xu, Xu
Xu, Xu, Xu, Xu, Cud^Sr, Xu, Xos, Xos, Uu^Uf, Rb, Uu, Uu, Xos, Xos, Xu, Xos, Qxu, Qxu, Qxu, Qxu, Uu, Cay^Sr, Cay^Sr, Cay^Sr, Uu, Qxu, Xos, Xos, Xu, Xu, Xu, Xu, Xu, Xu, Xu, Xu, Xu, Xu, Xu, Xu, Xu, Xu, Xu, Xu, Xu, Xu
Xu, Xu, Xu, Xu, Xu, Xu, Qxu, Qxu, Qxu, Rb, Uu, Xos, Cud, Xu, Xu, Xu, Qxu, Qxu, Qxu, Qxu, Qxu, Uh, Uh, Uu, Uh, Uu^Uf, Xu, Xu, Xu, Xu, Xu, Xu, Xu, Xu, Xu, Xu, Xu, Xu, Xu, Xu, Xu, Xu, Xu, Xu, Xu, Xu
Xu, Xu, Xu, Xu, Xu, Uu^Uf, Qxu, Qxu, Uh, Uu^Uf, Rb, Xos, Xu, Xu, Xu, Xu, Xu, Qxu, Qxu, Qxu, Qxu, Uh, Xos, Xos, Xu, Xu, Xu, Xu, Xu, Xu, Xu, Xu, Xu, Xu, Xu, Xu, Xu, Xu, Xu, Xu, Xu, Xu, Xu, Xu, Xu, Xu
Xu, Xu, Xu, Xu, Xu, Qxu, Qxu, Qxu, Uu^Uf, Uu, Rb, Xos, Xu, Xu, Xu, Xu, Xu, Xu, Xu, Qxu, Qxu, Qxu, Xos, Xu, Xu, Xu, Xu, Xu, Xu, Xu, Cud^Sr, Xu, Xu, Xu, Xu, Xu, Cud^Sr, Xu, Xu, Xu, Xu, Xu, Xu, Xu, Xu, Xu
Wog, Xu, Xu, Xu, Cud^Sr, Xu, Uh, Qxu, Rb, Rb, Qxu, Qxu, Qxu, Xu, Cud^Sr, Xu, Xu, Xu, Xu, Xu, Xu, Xos, Xu, Xu, Cud^Sr, Xu, Xos, Xu, Xos, Xos, Xos, Xos, Xos, Xu, Xos, Xos, Xos, Xos, Xos, Xu, Xu, Xu, Xu, Xu, Xu, Xu
Xu, Wog, Wog, Xu, Xu, Xu, Xos, Uh, Rb, Uu, Qxu, Qxu, Qxu, Xu, Xu, Xu, Qxu, Xu, Xu, Xu, Xu, Xu, Xu, Xu, Xos, Xos, Uh, Xos, Xos, Xos, Uu^Uf, Uu, Uh, Xos, Sm, Sm, Sm, Xos, Xos, Xu, Xu, Xu, Xu, Xu, Xu, Xu
Xu, Xu, Wog, Xu, Xu, Xu, Xu, Xos, Uu, Uu, Uh, Qxu, Qxu, Qxu, Qxu, Qxu, Qxu, Qxu, Qxu, Xu, Xu, Cud^Sr, Xos, Xos, Uh, Sm, Sm, Uu^Ufi, Sm, Uu^Ufi, Sm, Uh, Uu, Sm, Sm, Uu, Uh, Sm, Uu^Uf, Xos, Xu, Xu, Xu, Xu, Xu, Xu
Xu, Xu, Xu, Wog, Wog, Xu, Xu, Xos, Xos, Rb, Rb, Uh, Qxu, Qxu, Qxu, Qxu, Uu, Qxu, Qxu, Qxu, Uh, Xos, Sm, Uh, Uu^Ufi, Sm, Sm, Uu, Sm, Sm, Sm, Sm, Uu, Uu^Uf, Sm, Sm, Sm, Sm, Uu, Uh, Xos, Cud^Sr, Xu, Xu, Xu, Xu
Xu, Xu, Xu, Xu, Xu, Wog, Xu, Cud^Sr, Xu, Xos, Uu, Rb, Rb, Qxu, Uu, Rb, Uh, Uu, Rb, Uu^Uf, Uh, Rb, Sm, Uh, Sm, Sm, Uu^Uf, Sm, Uu^Uf, Uu, Xos, Xos, Xos, Sm, Xos, Xos, Xos, Sm, Sm, Uu, Sm, Xos, Xu, Xu, Xu, Xu
Xu, Xu, Xu, Xu, Xu, Wog, Xu, Xu, Wog, Xu, Xos, Uu, Uh, Uu, Rb, Rb, Xos, Uh, Uu^Uf, Uu, Uu, Rb, Uh, Sm, Sm, Uu, Uh, Uh, Xos, Xos, Xu, Cud^Sr, Xu, Xos, Xu, Xu, Cud^Sr, Xos, Uu, Sm, Uh, Xos, Xu, Xu, Xu, Xu
Xu, Xu, Xu, Xu, Xu, Wog, Wog, Xu, Xu, Wog, Xu, Xos, Xos, Uh, Xos, Xos, Cud^Sr, Xos, Xos, Uu^Uf, Rb, Uh, Xos, Uu^Uf, Xos, Xos, Xos, Xos, Xu, Xu, Xu, Xu, Xu, Xu, Xu, Xu, Xu, Xos, Uu^Ufi, Uu, Cud, Uh, Xu, Xu, Xu, Xu
Wog, Xu, Wog, Xu, Xu, Xu, Wog, Xu, Xu, Wog, Wog, Xu, Wog, Xu, Xu, Xu, Xu, Xu, Xu, Xos, Xos, Xos, Xu, Xu, Xu, Xu, Xu, Xu, Wog, Xu, Xu, Xu, Xu, Xu, Xu, Xu, Xos, Xos, Rb, Uu, Rb, Rb, Xu, Xu, Xu, Xu
Xu, Wog, Xu, Wog, Wog, Xu, Wog, Wog, Wog, Xu, Xu, Wog, Xu, Wog, Wog, Xu, Xu, Xu, Xu, Xu, Xu, Xu, Wog, Xu, Xu, Xu, Wog, Wog, Wog, Wog, Xu, Cud^Sr, Xu, Xu, Xu, Xos, Uu^Uf, Uh, Uh, Uu^Uf, Uu, Xos, Xu, Xu, Xu, Xu
Xu, Xu, Xu, Xu, Wog, Xu, Wog, Xu, Xu, Wog, Xu, Xu, Xu, Xu, Xu, Wog, Xu, Xu, Xu, Xu, Wog, Wog, Xu, Wog, Wog, Wog, Xu, Xu, Xu, Xu, Xu, Xu, Xu, Xu, Xos, Rb, Rb, Uu, Cay, Uu, Qxu, Xos, Xu, Xu, Xu, Xu
Xu, Xu, Xu, Xu, Xu, Wog, Xu, Xu, Xu, Wog, Wog, Xu, Xu, Xu, Xu, Wog, Wog, Xu, Xu, Xu, Wog, Xu, Xu, Xu, Xu, Xu, Cud^Sr, Xu, Xos, Xu, Xos, Xu, Xos, Xos, Uh, Uh, Rb, Cay, Kay, Cay, Qxu, Qxu, Xu, Xu, Xu, Xu
Xu, Xu, Xu, Xu, Xu, Wog, Xu, Xu, Xu, Xu, Xu, Wog, Wog, Xu, Wog, Wog, Xu, Wog, Wog, Wog, Xu, Xu, Xu, Xu, Xos, Xu, Xos, Xos, Wog, Xos, Cud, Xos, Uu^Uf, Rb, Rb, Uh, Uu, Cay, Cay, Cay, Qxu, Qxu, Xu, Xu, Xu, Xu
Xu, Xu, Xu, Xu, Xu, Wog, Xu, Xu, Xu, Xu, Xu, Xu, Xu, Wog, Xu, Xu, Xu, Xu, Xu, Xu, Xu, Cud^Sr, Xos, Xos, Wog, Xos, Uu, Uh, Wog, Wog, Rb, Uh, Rb, Rb, Cud, Uu, Qxu, Qxu, Qxu, Qxu, Qxu, Qxu, Xu, Xu, Xu, Xu
Wog, Xu, Xu, Xu, Wog, Wog, Wog, Xu, Xu, Xu, Xu, Xu, Xu, Wog, Xu, Xu, Xu, Xu, Xu, Xu, Xos, Xos, Uu, Ur, Wog, Wog, Wwg, Wwg, Wwg, Uu, Cud, Rb, Qxu, Uu, Uu, Rb, Qxu, Qxu, Qxu, Qxu, Xos, Xos, Xu, Xu, Xu, Xu
Xu, Wog, Wog, Wog, Xu, Xu, Wog, Xu, Xu, Xu, Cud^Sr, Xu, Xu, Wog, Xu, Xu, Xu, Cud^Sr, Xu, Xos, Uu^Ufi, Uh, Uu, Ur, Ur, Uh, Ur, Ur, Wog, Wog, Xos, Qxu, Qxu, Xu, Xu, Xu, Xos, Xos, Xos, Qxu, Xos, Xu, Xos, Cud^Sr, Xu, Xu
Xu, Xu, Xu, Xu, Xu, Xu, Wog, Xu, Xu, Xu, Xu, Xu, Wog, Wog, Wog, Wog, Uu^Uf, Xu, Uh, Uu^Ufi, Ur, Uu, Ur, Uu^Uf, Uh, Uh, Xu, Wog, Xu, Xos, Cud^Sr, Xos, Xos, Xu, Cud, Xu, Xos, Cud^Sr, Xos, Xos, Uu, Xos, Qxu, Xos, Xos, Xu
Xu, Xu, Xu, Xu, Xu, Wog, Wog, Wog, Xu, Uu^Ufi, Uh, Wog, Wwg, Wog, Wwg, Uh, Uu, Uh, Wwg, Wwg, Uh, Ur, Wog, Wog, Xos, Xos, Xos, Xu, Xos, Xu, Xu, Xos, Cud, Cud, Cud, Cud, Cud, Xos, Rb, Uu, Cay, Qxu, Qxu, Qxu, Xos, Xu
Xu, Xu, Xu, Xu, Xu, Xu, Xu, Xu, Gg, Uh, Gg, Wwf, Wwf, Wwg, Wwg, Wwg, Wwf, Wwf, Wwf, Wwg, Wwg, Uh, Xos, Xos, Uh, Uh, Uu, Uh, Uh, Xos, Xos, Xos, Rb, Rb, Rb, Uu, Uu, Rb, Uh, Cay, Kay, Cay, Qxu, Qxu, Xos, Xu
Xu, Xu, Xu, Cud^Sr, Xu, Xu, Uh, Gg, Gg, Gg, Gg, Wwf, Uu, Wwg, Wwg, Wog, Wog, Wwf, Wog, Wog, Wog, Wog, Xu, Xos, Uh, Uu^Vu, Uu^Uf, Uu^Uf, Uh, Uh, Uu^Uf, Uu, Cay, Cay, Cay, Uu, Rb, Uu^Vu, Uh, Cay, Cay, Cay, Uh, Qxu, Xos, Xu
Mm^Xm, Xu, Mm^Xm, Xu, Mm^Xm, Uh, Uh, Uu, Uu, Gg, Xu, Xu, Xu, Xu, Xu, Uu, Uu^Uf, Uu^Uf, Xu, Wog, Xu, Xu, Xos, Xos, Qxu, Uu, Cay, Uu, Uu, Uu, Rb, Uu, Cay, Kay, Cay, Uh, Rb, Rb, Rb, Uu, Uu^Uf, Uu^Uf, Xos, Xos, Xu, Xu
Mm^Xm, Mm^Xm, Mm^Xm, Mm^Xm, Mm^Xm, Hh, Hh, Uu, Xu, Xu, Xu, Xu, Xu, Cud^Sr, Xu, Xu, Xu, Xu, Cud^Sr, Xu, Xu, Xos, Qxu, Qxu, Uu, Cay, Kay, Cay, Uh, Rb, Uu^Vu, Rb, Uu^Uf, Cay, Uu, Uh, Uu, Uu^Vu, Uu^Uf, Uh, Uh, Uu^Uf, Xos, Xu, Xu, Xu
Mm, Mm, Mm^Xm, Mm^Xm, Mm, Mm, Mm, Mm^Xm, Xu, Cud^Sr, Xu, Xu, Xu, Xu, Xu, Xu, Xu, Xu, Xu, Xu, Xu, Xos, Qxu, Qxu, Uu^Uf, Cay, Cay, Cay, Uu, Uu^Uf, Uu, Uh, Uh, Uh, Xos, Rb, Rb, Rb, Uu, Uu^Uf, Uu, Uu, Xos, Cud^Sr, Xu, Xu
Mm, Mm, Mm, Mm, Hh, Mm, Mm, Mm^Xm, Mm^Xm, Xu, Xu, Xu, Xu, Xu, Xu, Xu, Xu, Xu, Xu, Xu, Xu, Xos, Xos, Uh, Uh, Uu^Uf, Rb, Rb, Uu^Uf, Uu^Uf, Xos, Xos, Xos, Xos, Cud^Sr, Xos, Xos, Xos, Xos, Rb, Rb, Uu, Uh, Xos, Xu, Xu
Mm, Mm, Mm, Mm, Hh, Hhd, Mm, Mm, Mm^Xm, Mm^Xm, Mm^Xm, Mm^Xm, Mm^Xm, Xu, Mm^Xm, Xu, Mm^Xm, Xu, Xu, Xu, Xu, Cud^Sr, Xos, Xos, Hh, Uu, Uu, Uu, Uh, Uh, Xos, Xu, Cud^Sr, Xu, Xu, Xu, Xu, Cud^Sr, Xos, Uu, Rb, Uh, Uh, Xos, Xu, Xu
Hh, Hhd, Hhd, Hh, Gg, Hhd, Hh, Mm, Mm, Mm, Mm, Mm^Xm, Mm^Xm, Mm^Xm, Mm, Mm^Xm, Mm, Mm^Xm, Mm, Mm^Xm, Mm^Xm, Xu, Mm^Xm, Mm^Xm, Hh, Hh, Mm, Mm^Xm, Mm, Hh, Mm^Xm, Xu, Xu, Xu, Mm^Xm, Xu, Mm^Xm, Xu, Mm^Xm, Hh, Hh, Uh, Mm, Mm^Xm, Xu, Xu
Gg, Gg, Gg, Gg, Gg^Ve, Gg, Gg, Hh, Hhd, Mm, Mm, Mm, Mm, Mm^Xm, Mm, Mm, Mm, Mm, Mm^Xm, Mm, Mm, Mm^Xm, Mm, Mm, Hhd, Mm, Mm, Mm, Mm, Hh, Mm, Mm^Xm, Mm^Xm, Mm^Xm, Mm, Mm^Xm, Mm, Mm^Xm, Mm, Hh, Hh, Mm, Mm, Mm^Xm, Mm^Xm, Xu
Gs^Fds, Gg, Gs^Fms, Gll^Fp, Gs^Fms, Gs^Fms, Gs^Fds, Gg, Hhd, Mm, Mm, Mm, Hhd, Mm, Mm, Mm, Mm, Mm, Mm, Mm^Xm, Mm^Xm, Mm, Mm, Mm, Gg, Hhd, Gg, Mm, Gg, Hh, Hhd, Mm, Mm, Mm, Mm^Xm, Mm, Mm, Mm, Gg, Gg, Hhd, Hhd, Mm, Mm, Mm, Mm
Gs^Fms, Gs^Fms, Gs^Fms, Gs^Fds, Gs^Fms, Gll^Fmf, Gs^Fms, Gg, Gg, Hh, Gg, Gg, Gg, Hh, Mm, Mm, Mm, Mm, Mm, Mm, Mm, Mm, Hh, Gg, Gs^Fms, Gs^Fds, Gll^Fdf, Gg, Gg, Hhd, Mm, Hh, Mm^Xm, Mm^Xm, Mm, Mm, Mm, Hh, Hh, Gg, Gg, Mm, Mm, Mm, Mm, Mm
Gs^Fms, Gs^Fms, Gs^Fms, Gll^Fmf, Gll^Fp, Gs^Fms, Gs^Fms, Gll^Fp, Gs^Fms, Gg, Gs^Fds, Gs^Fms, Gs^Fms, Hh, Hhd, Mm, Gg, Mm, Gg, Hh, Hhd, Hhd, Gg, Gs^Fms, Gs^Fms, Gs^Fms, Gs^Fms, Gs^Fms, Gg, Hh, Hh, Mm, Mm, Mm, Hh, Mm, Mm, Mm, Hh, Gg, Gg, Hh, Hhd, Hhd, Hh, Hh
Gs^Fms, Gs^Fms, Gg^Ve, Gs^Fms, Gs^Fms, Gll^Fp, Gs^Fms, Gll^Fmf, Gs^Fms, Gs^Fms, Gll^Fp, Gll^Fmf, Gs^Fms, Gs^Fms, Gs^Fds, Gg, Gg, Gg, Gs^Fms, Gg, Gg, Gg, Gg, Gs^Fms, Gs^Fms, Gll^Fp, Gs^Fms, Gs^Fds, Gs^Fms, Gg, Hhd, Mm, Mm, Mm, Hh, Hhd, Hhd, Mm, Mm, Gg, Gg, Gg, Gs^Fms, Gg, Gg, Gg
Gs^Fms, Gs^Fms, Gg, Gg, Gg, Gs^Fms, Gg, Gs^Fms, Gs^Fms, Gs^Fms, Gs^Fms, Gs^Fms, Gs^Fms, Gs^Fms, Gs^Fms, Gg, Gll^Fmf, Gs^Fms, Gs^Fms, Gs^Fds, Gs^Fms, Gg, Gg, Gll^Fp, Gll^Fmf, Gs^Fds, Gs^Fms, Gs^Fds, Gs^Fms, Gll^Fmf, Gg, Hhd, Mm, Mm, Mm, Hh, Gg, Mm, Mm, Hh, Gs^Fms, Gs^Fms, Gll^Fdf, Gs^Fms, Gll^Fdf, Gg
Gll^Fp, Gg, Gs^Fms, Gs^Fms, Gs^Fms, Gg, Gg, Gg, Gg, Gs^Fms, Gs^Fms, Gs^Fms, Gs^Fms, Gll^Fdf, Gs^Fds, Gg, Gs^Fms, Gs^Fms, Gs^Fms, Gs^Fms, Gs^Fms, Gs^Fms, Gg, Gg, Gg, Gs^Fms, Gs^Fms, Gll^Fdf, Gs^Fms, Gll^Fp, Gg, Gg, Gs^Fms, Mm, Gs^Fms, Gs^Fms, Gs^Fms, Hh, Hhd, Hhd, Gs^Fds, Gll^Fmf, Gll^Fp, Gs^Fms, Gs^Fms, Gg
Gs^Fms, Gs^Fms, Gs^Fds, Gll^Fmf, Gll^Fmf, Gll^Fdf, Gs^Fms, Gg, Gs^Fms, Gs^Fms, Gs^Fms, Gs^Fms, Gg^Ve, Gs^Fms, Gg, Gg, Gs^Fms, Gs^Fms, Gs^Fms, Gs^Fms, Gs^Fms, Gs^Fms, Gg, Gg^Ve, Gg, Gg, Gg, Gg, Gs^Fms, Gg, Gs^Fms, Gs^Fms, Gs^Fms, Gs^Fms, Gs^Fms, Gs^Fds, Gll^Fdf, Gg, Gs^Fms, Gs^Fms, Gll^Fmf, Gs^Fms, Gs^Fms, Gs^Fds, Gg, Gg
Gs^Fms, Gs^Fms, Gll^Fmf, Gll^Fmf, Gll^Fmf, Gll^Fmf, Gll^Fp, Gg, Gs^Fms, Gs^Fms, Gs^Fms, Gg, Gll^Fdf, Gs^Fms, Gs^Fms, Gg, Gg, Gs^Fms, Gs^Fms, Gs^Fds, Gg, Gg, Gs^Fms, Gs^Fms, Gs^Fms, Gg, Gg, Gll^Fdf, Gs^Fms, Gs^Fms, Gs^Fms, Gs^Fms, Gs^Fms, Gs^Fms, Gs^Fms, Gs^Fms, Gll^Fdf, Gg, Gs^Fms, Gs^Fms, Gs^Fms, Gll^Fdf, Gs^Fms, Gll^Fmf, Gg, Gg
Gg, Gg, Gll^Fmf, Gll^Fmf, Gll^Fmf, Gll^Fmf, Gs^Fds, Gg, Gg, Gll^Fp, Gg, Gg, Gs^Fms, Gs^Fms, Gs^Fms, Gg, Gg, Gg, Gg, Gg, Gg, Gs^Fms, Gs^Fms, Gs^Fds, Gs^Fms, Gs^Fms, Gll^Fmf, Gll^Fmf, Gs^Fms, Gs^Fms, Gg, Gll^Fmf, Gs^Fms, Gs^Fms, Gs^Fms, Gll^Fmf, Gg, Gg, Gg, Gs^Fms, Gs^Fms, Gs^Fms, Gs^Fms, Gg, Gg, Gg
Gs^Fms, Gs^Fms, Gs^Fms, Gll^Fmf, Gs^Fms, Gll^Fp, Gg, Gg, Gs^Fms, Gg, Gg, Gg, Gg, Gs^Fms, Gg, Gg, Gs^Fms, Gs^Fds, Gs^Fms, Gg, Gg, Gll^Fp, Gs^Fms, Gs^Fms, Gs^Fms, Gs^Fms, Gs^Fms, Gg, Gg, Gg, Gs^Fms, Gg, Gg, Gg, Gg, Gg, Gg, Gg, Gg, Gg, Gg, Gs^Fms, Gg, Gg, Gg^Ve, Gg
Gs^Fms, Gs^Fms, Gs^Fds, Gll^Fmf, Gll^Fmf, Gg, Gg, Gs^Fms, Gs^Fms, Gs^Fms, Gs^Fms, Gs^Fms, Gs^Fms, Gg, Gg, Gg, Gll^Fdf, Gs^Fms, Gll^Fp, Gs^Fms, Gs^Fms, Gs^Fms, Gll^Fmf, Gs^Fds, Gs^Fms, Gs^Fms, Gll^Fp, Gg, Gg, Gs^Fms, Gg^Ve, Gll^Fp, Gg, Gg, Gll^Fp, Gll^Fmf, Gs^Fms, Gs^Fms, Gs^Fms, Gg, Gll^Fmf, Gg, Gg, Gg, Gg, Gg
Gs^Fds, Gll^Fp, Gg, Gs^Fds, Gg, Gg, Gg, Gs^Fms, Gs^Fms, Gs^Fds, Gs^Fds, Gs^Fms, Gs^Fms, Gs^Fds, Gg, Gg^Ve, Gll^Fp, Gs^Fms, Gs^Fds, Gs^Fms, Gll^Fmf, Gg, Gg, Gg, Gs^Fms, Gs^Fms, Gs^Fms, Gll^Fp, Gg, Gs^Fms, Gs^Fms, Gs^Fms, Gg, Gll^Fp, Gs^Fms, Gs^Fms, Gs^Fds, Gs^Fms, Gll^Fdf, Gll^Fmf, Gs^Fds, Gs^Fms, Gg, Gg, Gg, Gg
Gg, Gg, Gg, Gg, Re, Re, Re, Gg, Gg, Gs^Fms, Gs^Fms, Gs^Fms, Gll^Fp, Gs^Fds, Gg, Gg, Gg, Gs^Fms, Gs^Fms, Gs^Fds, Gg, Gg, Gs^Fms, Gg, Gs^Fms, Gs^Fms, Gs^Fms, Gll^Fp, Gg, Gg, Gg, Gg, Gg, Gs^Fms, Gll^Fp, Gs^Fms, Gs^Fms, Gs^Fms, Gs^Fms, Gll^Fmf, Gll^Fmf, Gs^Fms, Gg, Gg, Gs^Fds, Gg
Gg, Gg, Gg, Re, Ce, Ce, Ce, Re, Gg, Gg, Gg, Gll^Fp, Gg, Gg, Gg, Gg, Gs^Fms, Gs^Fds, Gs^Fms, Gg, Gg, Gs^Fms, Gs^Fms, Gll^Fdf, Gg, Gs^Fms, Gg, Gg, Gs^Fms, Gs^Fms, Gll^Fmf, Gg, Gs^Fds, Gg, Gg, Gs^Fms, Gll^Fdf, Gs^Fms, Gg, Gs^Fms, Gg^Ve, Gg, Gg, Gs^Fms, Gll^Fmf, Gs^Fms
Gg, Gg, Gg, Ce, Ce, Ke, Ce, Gg, Gg, Gg, Gs^Fms, Gg, Gg, Gg, Gg, Gg, Gs^Fds, Gs^Fms, Gs^Fms, Gs^Fms, Gll^Fdf, Gs^Fms, Gll^Fdf, Gs^Fms, Gg, Gg, Gg, Gs^Fms, Gs^Fds, Gs^Fds, Gs^Fds, Gs^Fms, Gs^Fms, Gs^Fds, Gg, Gg, Gg, Gg, Gs^Fms, Gs^Fms, Gll^Fmf, Gg, Gs^Fms, Gs^Fms, Gs^Fms, Gll^Fmf
Gg, Gg, Re, Ce, Ce, Ce, Gg, Gg, Gg, Gs^Fms, Gs^Fms, Gs^Fms, Gll^Fmf, Gg, Gg, Gg, Gg, Gs^Fms, Gs^Fms, Gs^Fms, Gs^Fms, Gs^Fms, Gg, Gg, Gs^Fds, Gs^Fds, Gs^Fds, Gs^Fms, Gs^Fds, Gs^Fds, Gs^Fds, Gs^Fms, Gs^Fms, Gs^Fms, Gs^Fms, Gs^Fms, Gs^Fms, Gs^Fms, Gs^Fms, Gll^Fdf, Gs^Fms, Gg, Gll^Fmf, Gs^Fms, Gs^Fms, Gg
Re, Gg, Gg, Re, Re, Re, Gg, Gg, Gg, Gs^Fms, Gs^Fms, Gs^Fms, Gs^Fms, Gs^Fms, Gg, Gg, Gg^Ve, Gg, Gll^Fp, Gs^Fms, Gs^Fms, Gs^Fms, Gg, Gs^Fms, Gs^Fds, Gs^Fds, Gs^Fds, Gs^Fms, Gg, Gs^Fds, Gs^Fds, Gg, Gg, Gg, Gs^Fms, Gs^Fms, Gs^Fms, Gs^Fms, Gs^Fms, Gs^Fms, Gll^Fmf, Gs^Fms, Gs^Fms, Gs^Fms, Gs^Fds, Gg
Gg, Gg, Gg, Gg, Gg, Gg, Gg, Gg, Gg, Gs^Fms, Gs^Fms, Gs^Fms, Gll^Fp, Gll^Fdf, Gs^Fms, Gg, Gg, Gg, Gll^Fmf, Gs^Fms, Gs^Fms, Gg, Gg, Gs^Fms, Gs^Fms, Gs^Fds, Gs^Fms, Gll^Fmf, Gs^Fms, Gs^Fds, Gs^Fms, Gs^Fms, Gg, Gg, Gg, Gs^Fms, Rrc, Rrc, Rrc, Rrc, Gs^Fms, Gs^Fms, Gs^Fms, Gs^Fms, Gs^Fms, Gg
Gg, Gg, Gg, Gg, Gg, Ce^Vct, Ce, Ce^Vct, Gg, Gg, Gs^Fms, Gs^Fms, Gs^Fms, Gs^Fms, Gs^Fms, Gg, Gs^Fms, Gll^Fp, Gll^Fdf, Gll^Fmf, Gs^Fms, Gg, Gs^Fds, Gg, Gg, Gg, Gg, Gs^Fms, Gll^Fmf, Gg, Gg, Gs^Fms, Gs^Fds, Gg, Gg, Gg, Rrc^Ve, Ch, Rrc, Ch, Rrc^Ve, Gs^Fms, Gs^Fms, Gll^Fmf, Gs^Fds, Gll^Fmf
Gg, Gg, Gg, Gg, Ce^Vct, Ce, Ke, Ce, Ce^Vct, Re, Re, Gs^Fms, Gs^Fms, Gll^Fp, Gg, Gg, Gs^Fms, Gs^Fds, Gll^Fdf, Gs^Fds, Gs^Fds, Gs^Fms, Gs^Fms, Gs^Fms, Gg, Gg, Gg, Gs^Fms, Gs^Fms, Gs^Fms, Gll^Fp, Gs^Fms, Gs^Fms, Gs^Fms, Gg, Rrc, Rrc, Ch, Ch, Ch, Rrc, Gg, Gg, Gs^Fms, Gs^Fms, Gs^Fms
Gg, Gg, Gg, Gg, Gg, Ce, Ce, Ce, Re, Re, Gg, Gg, Gg, Gg, Gg, Gg, Gs^Fms, Gll^Fmf, Gs^Fms, Gs^Fms, Gs^Fms, Gs^Fms, Gll^Fdf, Gs^Fds, Gll^Fdf, Gg, Gg, Gg, Gg, Gs^Fms, Gg, Gll^Fp, Gg, Gg, Rrc, Rrc, Ch, Rrc^Ve, Kh, Rrc, Ch, Rrc^Ve, Rrc, Gg, Gg, Gg
Gg, Gg, Gg, Gg, Gg, Ce^Vct, Re, Ce^Vct, Re, Re, Gs^Fms, Gg, Gg, Gg, Gs^Fms, Gll^Fp, Gs^Fms, Gll^Fp, Gs^Fms, Gs^Fms, Gs^Fms, Gll^Fp, Gs^Fms, Gll^Fmf, Gll^Fmf, Gs^Fms, Gs^Fms, Gs^Fms, Gs^Fms, Gs^Fms, Gll^Fmf, Gg, Gg, Gg, Rrc, Rrc^Ve, Ch, Ch, Ch, Ch, Ch, Rrc, Gg, Rrc, Rrc, Gg
Gg, Gg, Gs^Fms, Gg, Gg, Gg, Gs^Fms, Re, Gs^Fms, Gs^Fds, Gs^Fms, Gll^Fp, Gg, Gg, Gs^Fms, Gs^Fds, Gs^Fms, Gs^Fms, Gll^Fdf, Gs^Fms, Gs^Fms, Gg, Gs^Fms, Gs^Fds, Gll^Fmf, Gs^Fms, Gs^Fms, Gs^Fds, Gll^Fdf, Gs^Fms, Gll^Fdf, Gs^Fms, Gs^Fms, Gs^Fms, Gs^Fms, Rrc, Gs^Fms, Rrc, Ch, Rrc^Ve, Rrc, Gg, Gs^Fms, Gg, Rrc, Gg
Gs^Fms, Gs^Fms, Gs^Fms, Gs^Fms, Gs^Fds, Gs^Fms, Gs^Fms, Gs^Fms, Gll^Fp, Gs^Fms, Gs^Fms, Gs^Fms, Gg, Gg, Gll^Fdf, Gs^Fms, Gs^Fms, Gs^Fms, Gs^Fms, Gs^Fds, Gg, Gg^Ve, Gg, Gs^Fms, Gs^Fms, Gs^Fds, Gs^Fms, Gs^Fds, Gs^Fms, Gs^Fms, Gs^Fms, Gs^Fms, Gs^Fms, Gs^Fms, Gs^Fms, Gs^Fds, Gs^Fms, Gs^Fms, Rrc, Rrc, Gg, Gll^Fp, Gs^Fms, Gll^Fp, Gg, Rrc
Gll^Fp, Gs^Fms, Gs^Fms, Gs^Fms, Gs^Fms, Gs^Fms, Gs^Fms, Gll^Fp, Gs^Fms, Gll^Fp, Gll^Fmf, Gs^Fds, Gg, Gg, Gg, Gs^Fms, Gs^Fms, Gs^Fms, Gs^Fds, Gs^Fms, Gll^Fmf, Gg, Gg, Gg, Gg, Gs^Fms, Gs^Fms, Gs^Fms, Gg, Gs^Fds, Gs^Fms, Gs^Fds, Gs^Fms, Gs^Fms, Gs^Fms, Gs^Fms, Gs^Fms, Gs^Fms, Gs^Fms, Gg, Gs^Fms, Gs^Fms, Gs^Fms, Gs^Fms, Gg, Gg
Gs^Fds, Gs^Fms, Gg^Ve, Gs^Fds, Gll^Fmf, Gs^Fms, Gll^Fp, Gll^Fp, Gll^Fmf, Gs^Fms, Gs^Fds, Gs^Fds, Gs^Fms, Gs^Fms, Gll^Fdf, Gg, Gg, Gg, Gs^Fms, Gs^Fms, Gs^Fms, Gs^Fms, Gs^Fms, Gs^Fms, Gs^Fms, Gg, Gg, Gg, Gs^Fms, Gs^Fms, Gll^Fdf, Gs^Fms, Gll^Fp, Gs^Fms, Gg, Gs^Fms, Gg, Gs^Fms, Gs^Fms, Gs^Fms, Gll^Fmf, Gs^Fms, Gs^Fms, Gll^Fmf, Gg, Gg
Gs^Fms, Gs^Fms, Gs^Fms, Gs^Fms, Gs^Fms, Gs^Fms, Gs^Fms, Gs^Fms, Gs^Fms, Gs^Fms, Gs^Fms, Gs^Fms, Gs^Fds, Gs^Fms, Gll^Fmf, Gg, Gg^Ve, Gg, Gs^Fms, Gs^Fms, Gll^Fp, Gs^Fms, Gll^Fp, Gll^Fp, Gs^Fms, Gs^Fds, Gg, Gg^Ve, Gs^Fms, Gs^Fms, Gll^Fmf, Gs^Fms, Gg, Gg, Gg^Ve, Gg, Gg, Gs^Fms, Gll^Fp, Gs^Fms, Gs^Fms, Gs^Fms, Gs^Fms, Gll^Fmf, Gg, Gg
Gg, Gs^Fms, Gs^Fms, Gs^Fms, Gs^Fms, Gs^Fds, Gs^Fms, Gs^Fms, Gg, Gs^Fms, Gg, Gs^Fms, Gs^Fms, Gs^Fms, Gll^Fp, Gg, Gg, Gg, Gg, Gs^Fms, Gg, Gs^Fms, Gs^Fms, Gs^Fds, Gs^Fms, Gs^Fms, Gg, Gg, Gg, Gs^Fds, Gg, Gg, Gg, Gg, Gg, Gg, Gg, Gg, Gg, Gs^Fds, Gg, Gg, Gg, Gg, Gg, Gg
