Xu, Xu, Xu, Xu, Xu, Xu, Xu, Xu, Xu, Xu, Xu, Xu, Xu, Xu, Xu, Xu, Xu, Xu, Xu, Xu, Xu, Xu, Xu, Xu, Xu, Xu, Xu, Xu, Xu, Xu, Xu, Xu, Xu, Xu, Xu, Xu, Xu, Xu, Xu, Xu, Xu, Xu, Xu, Xu, Xu, Xu, Xu, Xu, Xu, Xu, Xu, Xu, Rb
Xu, Xu, Xu, Xu, Xu, Xu, Xu, Xu, Xu, Xu, Xu, Xu, Xu, Xu, Xu, Xu, Xu, Xu, Xu, Xu, Xu, Xu, Xu, Xu, Xu, Xu, Xu, Xu, Xu, Xu, Xu, Xu, Xu, Xu, Xu, Xu, Xu, Xu, Xu, Xu, Xu, Xu, Xu, Xu, Xu, Xu, Xu, Xu, Xu, Xu, Uu, Rb, Uu
Xu, Xu, Xu, Xu, Xu, Xu, Xu, Xu, Xu, Xu, Xu, Xu, Xu, Xu, Xu, Xu, Xu, Xu, Xu, Xu, Xu, Xu, Xu, Xu, Xu, Xu, Xu, Xu, Rb, Xu, Xu, Xu, Uu, Rb, Uh, Xu, Qlfz, Xu, Xu, Xu, Xu, Xu, Uu, Xu, Xu, Xu, Uu, Xu, Uh, Uu, Rb, Uh, Uh
Xu, Xu, Xu, Xu, Xu, Xu, Qlfz, Xu, Qlfz, Qlfz, Qlfz, Qlfz, Qlfz, Xu, Qlfz, Qlfz, Qlfz, Xu, Tb, Tb, Uh, Rb, Rb, Xu, Qlfz, Xu, Tb, Uh, Rb, Uu, Uh, Uh, Uu^Vu, Rb, Uh, Tb, Qlfz, Qlfz, Qlfz, Xu, Rb, Tb, Uu^Vct, Rb, Rb, Rb, Ce, Uh, Uh^Ecf, Rb, Uu, Rb, Xu
Xu, Xu, Xu, Xu, Xu, Qlfz, Qlfz, Qlfz, Qlfz, Qlfz, Qlfz, Qlfz, Qlfz, Qlfz, Qlfz, Qlfz, Rb, Uh, Rb, Uh, Rb, Rb, Uh, Qlfz, Qlfz^Bcx/, Qlfz^Bcx/, Rb, Uh, Xu, Rb, Uh, Tb, Rb, Uu, Rb, Rb, Qlfz, Qlfz, Qlfz^Bcx/, Qlfz^Bcx/, Rb, Uh, Uh^Ecf, Uu, Ce, Ce, 1 Ke, Uu, Rb, Uu, Xu, Xu, Xu
Xu, Xu, Xu, Xu, Xu, Qlfz, Qlfz, Qlfz, Qlfz, Qlfz, Qlfz, Qlfz, Qlfz, Qlfz, Qlfz, Qlfz, Rb, Rb, Rb, Uu^Vu, Rb, Uu, Rb, Uh, Qlfz^Bcx/, Qlfz^Bcx/, Qlfz, Xu, Xu, Uu, Uu, Rb, Uu, Rb, Uu, Tb, Uu, Qlfz^Bcx/, Qlfz^Bcx/, Qlfz^Bcx/, Tb, Tb, Uh, Rb, Rb, Ce, Ce, Ce, Rb, Uu, Xu, Xu, Xu
Xu, Xu, Xu, Xu, Xu, Qlfz, Qlfz, Qlfz, Qlfz, Qlfz, Qlfz, Qlfz, Xu, Qlfz, Qlfz, Xu, Xu, Uu, Tb, Uh, Uu, Rb, Rb, Rb, Qlfz, Qlfz, Xu, Xu, Ql, Uu, Ql, Ql, Ql, Uh, Uh, Rb, Uu, Qlfz^Bcx/, Qlfz, Qlfz, Qlfz, Rb, Rb, Uu^Vct, Uu, Ce, Uh, Uu, Uu^Vct, Rb, Xu, Xu, Xu
Xu, Xu, Xu, Xu, Xu, Xu, Xu, Qlfz, Uh, Rb, Rb, Xu, Xu, Qlfz, Xu, Xu, Xu, Uu, Rb, Rb, Uu, Tb, Uh, Uu, Uu, Qlfz, Xu, Xu, Ql, Ql, Ql, Ql, Ql, Uh, Tb, Rb, Rb, Rb, Xu, Qlfz, Qlfz, Qlfz, Qlfz, Uu, Rb, Uh, Uh^Ecf, Rb, Uu, Uu, Xu, Xu, Xu
Xu, Xu, Xu, Xu, Xu, Xu, Xu, Tb, Uh, Uu^Vu, Rb, Xu, Xu, Xu, Xu, Xu, Xu, Xu, Rb, Uu^Vu, Uh, Tb, Xu, Uu, Rb, Xu, Xu, Xu, Tb, Ql, Ql, Ql, Ql^Bcx/, Ql^Bcx/, Ql^Bcx/, Rb, Uh, Uu^Vu, Xu, Xu, Xu, Qlfz, Qlfz, Rb, Tb, Uu, Rb, Rb, Tb, Tb, Xu, Xu, Xu
Xu, Xu, Xu, Xu, Xu, Xu, Xu, Xu, Uu, Uu, Rb, Uu, Xu, Xu, Tb, Uh, Rb, Xu, Rb, Rb, Xu, Xu, Xu, Rb, Rb, Uu, Uu, Tb, Uh, Uh, Uu, Rb, Uh, Ql^Bcx/, Ql, Tb, Uh, Ql, Ql, Xu, Xu, Qlfz, Qlfz, Qlfz^Bcx|, Qlfz^Bcx|, Tb, Uu, Uu, Qlfz, Qlfz, Qlfz, Xu, Xu
Xu, Xu, Xu, Xu, Xu, Xu, Xu, Xu, Rb, Rb, Rb, Uu, Xu, Xu, Xu, Uh, Cay, Rb, Uu, Rb, Tb, Xu, Xu, Uu, Uu^Vu, Rb, Rb, Uu, Rb, Uu^Vu, Uu, Rb, Uh, Ql, Ql, Rb, Ql, Ql, Xu, Xu, Xu, Xu, Xu, Qlfz^Bcx|, Qlfz^Bcx|, Qlfz, Qlfz, Qlfz, Qlfz, Qlfz, Qlfz, Xu, Xu
Xu, Xu, Xu, Xu, Xu, Xu, Ql, Ql, Rb, Uu, Uu, Rb, Uu, Xu, Uh, Uu, Cay, 8 Kay, Cay, Uh, Xu, Xu, Xu, Tb, Tb, Uh, Uu, Rb, Uu, Rb, Uu, Uh, Ql, Ql, Ql, Ql, Uu, Ql, Uh, Xu, Tb, Xu, Rb, Rb, Rb, Qlfz, Xu, Qlfz, Xu, Qlfz, Xu, Xu, Xu
Xu, Xu, Xu, Xu, Xu, Xu, Ql, Ql, Ql, Uh, Uu, Rb, Rb, Uu^Vu, Rb, Uu, Rb, Cay, Rb, Uh, Xu, Xu, Xu, Xu, Xu, Uh, Ql, Uu, Ql^Bcx|, Ql, Ql, Tb, Ql, Ql, Uh, Rb, Uu, Rb, Rb, Uh, Uu, Uu, Uu, Uu, Uu, Xu, Xu, Xu, Xu, Xu, Xu, Xu, Xu
Xu, Xu, Xu, Xu, Xu, Xu, Xu, Ql, Ql, Uh, Tb, Uu, Uh, Rb, Tb, Rb, Xu, Rb, Uu, Tb, Xu, Xu, Ql, Ql, Ql, Ql, Ql, Ql^Bcx|, Ql^Bcx|, Ql, Ql, Ql, Ql, Ql, Uh, Tb, Xu, Rb, Rb, Uu^Vu, Rb, Rb, Uh, Tb, Rb, Rb, Rb, Uh, Tb, Xu, Qlfz, Xu, Xu
Xu, Xu, Xu, Xu, Xu, Xu, Xu, Xu, Ql, Ql, Ql, Ql, Ql, Uh, Tb, Xu, Xu, Uh, Ql, Xu, Ql, Ql, Ql, Ql, Ql, Ql, Uh, Ql^Bcx|, Rb, Uh, Rb, Ql, Ql^Bcx/, Ql^Bcx/, Ql^Bcx/, Uh, Xu, Xu, Xu, Uh, Tb, Uu, Rb, Uh, Rb, Uu^Vu, Uu, Tb, Uh, Qlfz, Qlfz, Xu, Xu
Xu, Xu, Xu, Xu, Xu, Xu, Xu, Xu, Xu, Ql, Ql, Ql, Ql, Ql, Xu, Xu, Xu, Ql, Ql, Ql, Ql, Ql, Rb, Uu, Tb, Uh, Tb, Uu, Uu, Uh, Tb, Rb, Uu, Ql^Bcx/, Ql, Ql, Ql, Xu, Xu, Uh, Uh, Rb, Uu, Rb, Uu, Uh, Uu, Rb, Rb, Qlfz, Qlfz, Xu, Xu
Xu, Xu, Xu, Xu, Xu, Xu, Xu, Xu, Xu, Xu, Xu, Xu, Xu, Xu, Xu, Xu, Xos, Xos, Xos, Ql, Tb, Rb, Uh, Rb, Uu, Uh, Rb, Rb, Tb, Rb, Uu, Rb, Uh, Rb, Rb, Ql, Ql, Xu, Xu, Xu, Rb, Uu, Uh, Uu^Vu, Rb, Uh, Qlfz, Rb, Qlfz, Qlfz, Qlfz, Xu, Xu
Xu, Xu, Xu, Xu, Xu, Xu, Xu, Xu, Xu, Xu, Xu, Xu, Xu, Xu, Xu, Xu, Tb, Uh, Uh, Xu, Xu, Tb, Uh, Uu, Xu, Xu, Xu, Tb, Uh, Rb, Rb, Uu, Uh, Tb, Uu, Ql, Ql, Ql, Xu, Xu, Rb, Uu, Uh, Tb, Xu, Qlfz, Qlfz, Qlfz, Qlfz, Qlfz, Qlfz, Xu, Xu
Xu, Xu, Xu, Xu, Xu, Xu, Xu, Xu, Ql, Xu, Ql, Xu, Xu, Xu, Xu, Xu, Ql, Tb, Uh, Rb, Ql, Xos, Xos, Xu, Xos, Xu, Xu, Xos, Uh, Uh, Uu, Uu, Rb, Uh, Rb, Uu, Ql, Ql, Ql, Xu, Ql^Bcx|, Rb, Ql, Uh, Xu, Xu, Qlfz, Qlfz, Xu, Xu, Xu, Xu, Xu
Xu, Xu, Xu, Xu, Xu, Xu, Xu, Ql, Ql, Ql, Ql, Ql, Ql, Ql, Ql, Ql, Ql, Rb, Uu, Ql, Ql, Ql, Xos, Xos, Xos, Xos, Xos, Xos, Ur, Rb, Xos, Xos, Tb, Rb, Uh, Uu, Ql, Ql, Ql, Ql, Ql^Bcx|, Ql^Bcx|, Ql, Ql, Xu, Xu, Xu, Qlfz, Xu, Xu, Xu, Xu, Xu
Xu, Xu, Xu, Xu, Xu, Xu, Ql, Ql, Ql, Ql, Uh, Ql, Ql, Ql, Uh, Ql, Uu, Uu^Vu, Rb, Ql, Xu, Xu, Xos, Xos, Xos, Tb, Uu, Rb, Rb, Ur, Xos, Xu, Xu, Tb, Uh, Uh, Ql, Ql, Tb, Ql, Uu, Ql^Bcx|, Tb, Ql, Ql, Xu, Xu, Xu, Xu, Ql, Ql, Xu, Xu
Xu, Xu, Xu, Xu, Xu, Xu, Ql, Ql, Rb, Uh, Uu^Vu, Uu, Uh, Uu, Rb, Rb, Uh, Uh, Xu, Xu, Xos, Xos, Xos, Xos, Rb, Uh, Rb, Uu, Rb, Xos, Xos, Xu, Xu, Xu, Tb, Ql, Ql, Ql, Uh, Rb, Uu, Uh, Tb, Rb, Ql, Xu, Xu, Xu, Ql, Ql, Ql, Xu, Xu
Xu, Xu, Xu, Xu, Xu, Xu, Ql, Ql, Uh, Rb, Qlfz, Tb, Uh, Rb, Rb, Uu, Qlfz, Tb, Xu, Xos, Uh, Uu, Uu, Uu, Uh, Rb, Xos, Uu, Uu, Uh, Uh, Xos, Xos, Xu, Xu, Ql, Ql, Uh, Rb, Rb, Uu^Vu, Uh, Uh, Rb, Rb, Ql, Ql, Xu, Ql, Ql, Xu, Xu, Xu
Xu, Xu, Xu, Xu, Xu, Xu, Tb, Rb, Uh, Tb, Qlfz, Qlfz, Qlfz, Uu, Uh, Qlfz, Qlfz, Xu, Xos, Xos, Uh, Uu, Uu, Uh, Xos, Xos, Uu, Xos, Xos, Uu, Rb, Rb, Tb, Xos, Xos, Xu, Ql, Ql, Rb, Uu, Rb, Rb, Uu, Uu, Uu, Ql, Ql, Ql, Ql, Ql, Xu, Xu, Xu
Xu, Xu, Xu, Xu, Xu, Xu, Uh, Rb, Rb, Qlfz, Qlfz, Qlfz, Rb, Uu^Vu, Uh, Qlfz, Qlfz, Xu, Xos, Tb, Tb, Rb, Xos, Xos, Uu, Qlfz, Qlfz, Uu, Qlfz, Xos, Xos, Rb, Uh, Tb, Xos, Xu, Xu, Ql, Ql, Uu, Uh, Rb, Uu, Rb, Uh, Tb, Uh, Ql, Ql, Xu, Xu, Xu, Xu
Xu, Xu, Xu, Xu, Xu, Uh, Rb, Uu^Vu, Uh, Uu, Uu, Uh, Uh, Rb, Tb, Tb, Uh, Xu, Xos, Uh, Rb, Rb, Xos, Uu, Qlfz, Qlfz, Uu, Qlfz, Qlfz, Qlfz, Xos, Uu, Rb, Uh, Uu, Xos, Xu, Ql, Ql, Uu, Tb, Uh, Uu, Rb, Rb, Uh, Rb, Ql, Ql, Xu, Xu, Xu, Xu
Xu, Xu, Xu, Xu, Qlfz, Qlfz, Qlfz, Uh, Uh, Rb, Uh, Rb, Ql, Ql, Ql, Uh, Xu, Xu, Xos, Uh, Uu, Uu, Xos, Qlfz, Qlfz, Uu, Cay^Ii, Uu, Qlfz, Qlfz, Xos, Uu, Ql, Rb, Ql, Ql, Ql^Xo, Ql, Ql, Tb, Rb, Uh, Rb, Uu, Uu^Vu, Uu, Rb, Ql, Ql, Ql, Ql, Xu, Xu
Xu, Xu, Xu, Xu, Qlfz, Qlfz, Uu, Uu, Cay, Rb, Rb, Uh, Ql, Ql, Ql, Xu, Xu, Xu, Xos, Uu, Rb, Uu, Xos, Qlfz, Qlfz, Uu, Uu, Uu, Qlfz, Uu, Xos, Ql, Ql, Ql, Ql, Ql, Ql^Xo, Ql, Ql, Ql, Xu, Rb, Uu, Uu, Uu, Rb, Cay, Cay, Cay, Ql, Ql, Xu, Xu
Xu, Xu, Xu, Qlfz, Qlfz, Qlfz, Rb, Cay, 6 Kay, Cay, Rb, Uh, Uu, Ql, Ql, Ql, Ql, Ql^Xo, Ql, Ql, Rb, Uu, Xos, Uu, Qlfz, Qlfz, Uu, Qlfz, Uu, Uu, Xos, Ql, Ql, Ql, Xos, Xos, Xu, Xu, Xu, Xu, Xu, Xu, Uh, Rb, Rb, Uu, Cay, 3 Kay, Cay, Ql, Ql, Xu, Xu
Xu, Xu, Xu, Qlfz, Qlfz, Rb, Uh, Cay, Cay, Cay, Uh, Rb, Uh, Ql, Ql, Ql, Ql, Ql^Xo, Ql, Ql, Tb, Rb, Uu, Xos, Xos, Qlfz, Uu, Qlfz, Xos, Xos, Rb, Uh, Uh, Uh, Xos, Xu, Xu, Xu, Ql, Xu, Xu, Xu, Uh, Rb, Uu, Uh, Tb, Cay, Ql, Ql, Ql, Xu, Xu
Xu, Xu, Qlfz, Qlfz, Qlfz, Rb, Uh, Uh, Rb, Uu, Qlfz, Rb, Xu, Xu, Xu, Ql, Ql, Ql^Xo, Xos, Tb, Rb, Uu, Uu, Uu, Uu, Cay, 2 Kay, Cay, Uu, Uu, Rb, Uu, Rb, Xos, Xu, Xu, Xu, Ql, Ql, Ql, Ql, Uh, Rb, Uu, Uu^Vu, Rb, Rb, Ql, Ql, Ql, Xu, Xu, Xu
Xu, Xu, Uh, Qlfz, Rb, Uu, Uu, Rb, Uh, Qlfz, Qlfz, Qlfz, Xu, Xu, Xu, Xu, Xu, Xu, Xu, Xos, Rb, Uu, Rb, Uh, Uu, Cay, Cay, Cay, Uu, Rb, Uh, Uh, Rb, Xos, Xos, Xu, Xu, Ql, Ql, Ql, Tb, Tb, Rb, Uu, Rb, Rb, Ql, Ql, Ql, Xu, Xu, Xu, Xu
Xu, Xu, Rb, Uh, Rb, Uu^Vu, Uh, Rb, Qlfz, Qlfz, Qlfz, Xu, Xu, Xu, Qlfz, Xu, Xu, Xu, Xu, Xos, Xos, Uh, Rb, Uh, Uh, Uu, Rb, Rb, Uu, Uu, Uh, Rb, Qlfz, Qlfz, Qlfz, Xu, Xu, Xu, Ql, Ql, Ql, Rb, Ql, Uu, Uh, Tb, Ql, Ql, Xu, Xu, Xu, Xu, Xu
Xu, Xu, Xu, Rb, Qlfz, Qlfz, Uh, Rb, Uu, Qlfz, Xu, Xu, Xu, Qlfz, Qlfz, Qlfz, Xu, Xu, Ql^Xo, Xu, Qlfz, Uh, Uu, Rb, Uu, Uu, Uu, Rb, Uu, Rb, Uu, Rb, Qlfz, Qlfz, Xu, Xu, Xu, Xu, Xu, Ql, Ql, Ql, Ql, Uu, Uh, Ql, Ql, Xu, Xu, Xu, Xu, Xu, Xu
Xu, Xu, Xu, Qlfz, Qlfz, Qlfz, Qlfz, Rb, Rb, Uu^Vu, Uh, Xu, Uh, Qlfz, Qlfz, Qlfz, Qlfz, Ql, Ql^Xo, Ql, Qlfz, Qlfz, Uu, Uh, Rb, Rb, Rb, Uu, Rb, Rb, Uu, Qlfz, Qlfz, Qlfz, Xu, Xu, Xu, Xu, Xu, Ql, Ql, Ql, Ql, Uh, Ql, Ql, Xu, Xu, Xu, Xu, Xu, Xu, Xu
Xu, Xu, Xu, Xu, Qlfz, Qlfz, Qlfz, Qlfz, Uh, Uu, Rb, Uh, Rb, Rb, Qlfz, Qlfz, Qlfz, Ql, Ql^Xo, Ql, Ql, Qlfz, Qlfz, Uu, Qlfz, Qlfz, Qlfz, Uu, Qlfz, Uu, Qlfz, Qlfz, Qlfz, Qlfz, Xu, Xu, Xu, Xu, Xu, Xu, Xu, Ql, Ql, Ql, Ql, Ql, Xu, Xu, Xu, Xu, Xu, Xu, Xu
Xu, Xu, Xu, Xu, Xu, Qlfz, Xu, Qlfz, Xu, Uh, Rb, Rb, Rb, Uh, Rb, Qlfz, Xu, Xu, Xu, Ql^Xo, Ql, Ql, Qlfz, Qlfz, Qlfz, Qlfz, Qlfz, Qlfz, Ql, Qlfz, Qlfz, Qlfz, Qlfz, Xu, Xu, Xu, Xu, Xu, Xu, Xu, Xu, Ql, Xu, Xu, Xu, Xu, Xu, Xu, Xu, Xu, Xu, Xu, Xu
Xu, Xu, Xu, Xu, Xu, Xu, Xu, Xu, Xu, Xu, Uh, Uh, Uu, Uu, Rb, Qlfz, Qlfz, Xu, Xu, Xu, Xu, Ql, Ql, Qlfz, Ql, Ql, Ql, Ql, Ql, Ql, Ql, Qlfz, Ql, Xu, Xu, Xu, Xu, Xu, Xu, Xu, Xu, Xu^Uov, Xu^Uov, Xu^Uov, Xu^Uov, Xu, Xu^Uov, Xu, Xu, Xu, Xu, Xu, Xu
Xu, Xu, Xu, Xu, Xu, Xu, Xu, Xu, Xu, Xu, Xu, Uh, Qlfz, Uu, Qlfz^Bcx\, Qlfz^Bcx\, Qlfz^Bcx\, Qlfz, Xu, Xu, Ql^Xo, Ql, Ql, Ql, Ql, Ql, Ql, Ql, Xu, Ql, Ql, Ql, Ql^Xo, Ql^Xo, Xu, Xu, Xu, Xu, Xu, Xu, Xu, Xu, Xu, Xu, Xu, Xu^Uov, Xu, Xu^Uov, Xu^Uov, Xu, Xu, Xu, Xu
Xu, Xu, Xu, Xu, Xu, Xu, Xu, Xu, Xu, Xu, Xu, Xu, Qlfz, Qlfz, Qlfz, Qlfz^Bcx\, Uh, Qlfz^Bcx\, Rb, Xu, Ql, Ql^Xo, Xu, Ql, Xu, Xu, Xu, Xu, Xu, Xu, Xu, Ql^Xo, Ql, Ql, Xu, Xu, Xu, Xu, Qlfz, Xu, Qlfz, Xu, Xu, Xu, Qlfz, Xu, Xu, Xu, Xu, Xu^Uov, Xu, Xu, Xu
Xu, Xu, Xu, Xu, Xu, Xu, Ql, Xu, Ql, Ql, Ql, Xu, Xu, Qlfz, Qlfz, Uu, Uh, Uh, Rb, Uu, Ql, Ql, Xu, Xu, Xu, Xu, Ql, Xu, Ql, Xu, Xu, Xu, Ql, Ql, Ql, Xu, Qlfz, Qlfz, Qlfz, Qlfz, Qlfz, Qlfz, Qlfz, Qlfz, Qlfz, Qlfz, Qlfz, Xu, Xu, Xu^Uov, Xu, Xu, Xu
Xu, Xu, Xu, Xu, Ql, Ql, Ql, Ql, Ql, Ql, Ql, Xu, Xu, Qlfz, Rb, Uu, Uu, Tb, Rb, Uu, Rb, Ql, Rb, Xu, Uh, Ql, Ql, Ql, Ql, Ql, Xu, Xu, Xu, Ql, Qlfz, Qlfz, Qlfz, Qlfz, Xu, Qlfz, Xu, Qlfz, Qlfz, Qlfz, Tb, Qlfz, Qlfz, Qlfz, Xu, Xu^Uov, Xu, Xu, Xu
Xu, Xu, Xu, Xu, Ql, Ql, Uu, Ql, Uh, Ql, Ql, Xu, Xu, Xu, Rb, Rb, Rb, Rb, Uu, Uh, Uh, Tb, Uu^Vu, Uh, Rb, Rb, Uh, Uh, Rb, Ql, Xu, Xu, Xu, Xu, Qlfz, Qlfz, Qlfz, Xu, Xu, Xu, Xu, Xu, Xu, Tb, Uu^Vud, Uu, Qlfz, Qlfz, Xu, Xu^Uov, Xu^Uov, Xu, Rb
Xu, Xu, Xu, Ql, Ql, Rb, Uu^Vu, Tb, Uh, Uu, Rb, Rb, Rb, Uh, Uh, Uu, Uu, Rb, Qlfz, Xu, Xu, Rb, Rb, Uu, Xu, Uu, Uu, Rb, Rb, Uh, Rb, Xu, Xu, Xu, Qlfz, Qlfz, Qlfz, Xu, Xu, Xu, Uh, Xu, Uu, Uh, Uh, Uu, Uh, Qlfz, Xu, Xu, Uh, Rb, Uh
Xu, Xu, Ql, Ql, Ql, Ql, Cay, Cay, Cay, Uu, Uu, Uh, Rb, Tb, Uh, Tb, Rb, Qlfz, Qlfz, Xu, Xu, Xu, Qlfz, Qlfz, Qlfz, Xu, Xu, Rb, Tb, Uh, Rb, Xu, Xu, Qlfz, Qlfz, Qlfz, Qlfz, Qlfz, Uu, Tb, Uh, Tb, Uu, Rb, Rb, Rb, Uh, Uh, Tb, Uu, Rb, Uu, Rb
Xu, Xu, Ql, Ql, Ql, Rb, Cay, 7 Kay, Cay, Rb, Rb, Uh, Uu, Uu, Rb, Rb, Uu, Qlfz, Qlfz, Qlfz, Qlfz, Qlfz, Qlfz, Qlfz, Qlfz, Xu, Xu, Uh, Uh, Uu^Vu, Uu, Xu, Xu, Qlfz, Qlfz, Qlfz, Qlfz, Qlfz, Uu, Uu^Vud, Rb, Uh, Qlfz, Qlfz, Cud, Uu, Uu, Tb, Uu^Vud, Rb, Uh, Rb, Uu
Xu, Xu, Xu, Ql, Uh, Uh, Tb, Cay, Uh, Rb, Xu, Xu, Xu, Uu^Vu, Rb, Rb, Xu, Xu, Qlfz, Qlfz, Qlfz, Qlfz, Qlfz, Qlfz, Qlfz, Qlfz, Qlfz, Qlfz, Uh, Uu, Rb, Xu, Xu, Xu, Xu^Uov, Xu, Xu, Tb, Uh, Rb, Uu, Qlfz, Qlfz, Cud, 5 Kud, Cud, Qlfz, Qlfz, Uu, Uu, Uh, Uh, Xu
Xu, Xu, Xu, Rb, Tb, Uh, Ql, Uh, Ql, Ql, Xu, Xu, Ql, Ql, Uh, Tb, Uh, Xu, Qlfz, Qlfz, Xu, Qlfz, Qlfz, Qlfz, Uu, Qlfz, Qlfz, Qlfz, Rb, Rb, Rb, Uh, Xu^Uov, Xu^Uov, Xu, Xu^Uov, Xu, Uh, Tb, Rb, Rb, Qlfz, Xu, Qlfz, Cud, Cud, Qlfz, Qlfz, Rb, Rb, Xu, Xu, Xu
Xu, Xu, Xu, Xu, Ql, Ql, Ql, Ql, Ql, Ql, Xu, Xu, Ql, Ql, Ql, Uh, Uu, Qlfz, Qlfz, Qlfz, Xu, Xu, Uh, Rb, Rb, Uu, Rb, Tb, Rb, Uu, Uu, Uh, Xu, Xu, Qlfz, Xu^Uov, Ur, Uh, Uu^Vud, Uu, Uu, Xu, Xu, Qlfz, Qlfz, Cud, Uu, Uu, Uh, Rb, Xu, Xu, Xu
Xu, Xu, Xu, Xu, Xu, Ql, Xu, Ql, Ql, Xu, Xu, Xu, Ql, Ql, Ql, Rb, Rb, Rb, Rb, Uu^Vu, Uu, Uh, Rb, Tb, Rb, Uu, Uh, Rb, Tb, Uh, Uu, Rb, Qlfz, Qlfz, Qlfz, Qlfz, Qlfz, Rb, Rb, Uh, Rb, Rb, Uu^Vud, Qlfz, Rb, Rb, Uu, Tb, Uh, Qlfz, Qlfz, Xu, Xu
Xu, Xu, Xu, Xu, Xu, Xu, Xu, Ql, Xu, Xu, Xu, Ql, Ql, Ql, Uh, Rb, Uu, Uh, Tb, Rb, Uu, Rb, Xu, Uh, Xu, Rb, Qlfz, Uh, Qlfz, Uh, Uh, Rb, Qlfz, Qlfz, Xu, Qlfz, Qlfz, Qlfz, Rb, Uh, Uh, Rb, Uu, Uh, Rb, Uu, Qlfz, Tb, Qlfz, Qlfz, Qlfz, Xu, Xu
Xu, Xu, Xu, Xu, Xu, Xu, Xu, Xu, Xu, Xu, Xu, Xu, Ql, Ql, Uh, Uu, Qlfz, Qlfz, Qlfz, Qlfz, Qlfz, Xu, Xu, Xu^Uov, Xu, Xu, Xu, Qlfz, Qlfz, Qlfz, Qlfz, Qlfz, Qlfz, Qlfz, Xu, Xu, Xu, Xu, Xu, Tb, Tb, Qlfz, Qlfz, Uh, Uh, Uu, Qlfz, Qlfz, Qlfz, Qlfz, Qlfz, Xu, Xu
Xu, Xu, Xu, Xu, Qlfz, Qlfz, Qlfz, Xu, Qlfz, Qlfz, Qlfz, Xu, Xu, Rb, Rb, Uh, Rb, Qlfz, Qlfz, Qlfz, Qlfz, Xu, Xu, Xu^Uov, Xu^Uov, Xu, Xu, Qlfz, Rb, Qlfz, Qlfz, Qlfz, Qlfz, Qlfz, Qlfz, Xu, Xu, Xu, Qlfz, Rb, Uu, Rb, Qlfz, Qlfz, Uu^Vud, Rb, Rb, Qlfz, Qlfz, Qlfz, Qlfz, Xu, Xu
Xu, Xu, Xu, Xu, Qlfz, Qlfz, Rb, Rb, Uh, Qlfz, Rb, Xu, Xu, Tb, Uh, Rb, Tb, Qlfz, Qlfz, Qlfz, Uh, Qlfz, Xu, Xu, Xu, Xu^Uov, Tb, Uu, Rb, Tb, Cud, Tb, Tb, Qlfz, Uu, Xu, Xu, Qlfz, Qlfz, Qlfz, Uu, Rb, Uh, Qlfz, Uu, Rb, Xu, Xu, Qlfz, Qlfz, Qlfz, Xu, Xu
Xu, Xu, Xu, Xu, Qlfz, Qlfz, Qlfz, Tb, Uh, Uu, Uu, Uh, Rb, Uh, Uu, Rb, Rb, Uh, Uu^Vu, Uh, Rb, Tb, Rb, Xu, Rb, Uh, Tb, Rb, Uh, Cud, 4 Kud, Cud, Rb, Rb, Uh, Tb, Tb, Tb, Qlfz^Bcx/, Qlfz^Bcx/, Qlfz^Bcx/, Rb, Tb, Uh, Rb, Uu, Xu, Xu, Qlfz, Qlfz, Qlfz, Xu, Xu
Xu, Xu, Xu, Xu, Xu, Qlfz, Qlfz, Rb, Rb, Rb, Xu, Uu^Vu, Rb, Rb, Uu, Uu, Uh, Rb, Rb, Uu, Xu, Rb, Rb, Uu, Rb, Uh, Uu^Vud, Uh, Uh, Cud, Cud, Cud, Uh, Rb, Uh, Uh, Uu^Vud, Uu, Rb, Qlfz^Bcx/, Qlfz, Qlfz, Tb, Uh, Rb, Uu, Xu, Xu, Qlfz, Qlfz, Xu, Xu, Xu
Xu, Xu, Xu, Xu, Xu, Qlfz, Qlfz, Qlfz, Xu, Xu, Xu, Xu, Xu, Xu, Xu, Rb, Uh, Uh, Rb, Xu, Xu, Qlfz, Qlfz, Uu, Uh, Rb, Uu, Rb, Uu, Rb, Rb, Uh, Uu, Uu, Rb, Uh, Uu, Rb, Uu, Rb, Qlfz, Qlfz, Qlfz, Rb, Qlfz, Xu, Qlfz, Qlfz, Qlfz, Qlfz, Xu, Xu, Xu
Xu, Xu, Xu, Xu, Xu, Xu, Qlfz, Qlfz, Qlfz, Xu, Qlfz, Xu, Xu, Xu, Uu, Rb, Rb, Tb, Qlfz, Xu, Qlfz, Qlfz, Tb, Rb, Uh, Uh, Rb, Rb, Xu, Uu, Rb, Uu, Xu, Uu, Rb, Rb, Uh, Uh, Rb, Uu, Uu, Qlfz, Qlfz, Qlfz, Qlfz, Qlfz, Qlfz, Qlfz, Qlfz, Qlfz, Xu, Xu, Xu
Xu, Xu, Xu, Xu, Xu, Xu, Xu, Qlfz, Qlfz, Qlfz, Qlfz, Qlfz, Xu, Xu, Uu, Uh, Uh, Qlfz, Qlfz, Qlfz, Qlfz, Qlfz, Xu, Uh, Uu^Vud, Uh, Tb, Xu, Xu, Cud, Cud, Cud, Xu, Xu, Uu, Uu, Uh, Rb, Rb, Uh, Uh, Qlfz, Qlfz, Qlfz, Qlfz, Qlfz, Qlfz, Qlfz, Qlfz, Qlfz, Xu, Xu, Xu
Xu, Xu, Xu, Xu, Xu, Xu, Xu, Xu, Xu, Qlfz, Qlfz, Qlfz, Qlfz, Qlfz, Qlfz, Rb, Xu, Xu, Xu, Xu, Xu, Xu, Xu, Xu, Xu, Tb, Xu, Xu, Xu, Cud, Rrc, Cud, Xu, Xu, Xu, Tb, Tb, Tb, Uh, Uu^Vud, Tb, Xu, Xu, Qlfz, Qlfz, Qlfz, Xu, Qlfz, Xu, Xu, Xu, Xu, Xu
Xu, Xu, Xu, Xu, Xu, Xu, Xu, Xu, Xu, Qlfz, Qlfz, Qlfz, Qlfz, Qlfz, Qlfz, Qlfz, Xu, Xu, Xu, Xu, Xu, Xu, Xu, Xu, Xu, Xu, Xu, Xu, Xu, Rrc, Rrc, Rrc, Xu, Xu, Xu, Xu, Xu, Xu, Xu, Tb, Xu, Xu, Xu, Xu, Xu, Xu, Xu, Xu, Xu, Xu, Xu, Xu, Xu
Xu, Xu, Xu, Xu, Xu, Xu, Xu, Xu, Xu, Xu, Xu, Qlfz, Xu, Qlfz, Xu, Xu, Xu, Xu, Xu, Xu, Xu, Xu, Xu, Xu, Xu, Xu, Xu, Xu, Xu, Rrc, Rrc, Rrc, Xu, Xu, Xu, Xu, Xu, Xu, Xu, Xu, Xu, Xu, Xu, Xu, Xu, Xu, Xu, Xu, Xu, Xu, Xu, Xu, Xu
Xu, Xu, Xu, Xu, Xu, Xu, Xu, Xu, Xu, Xu, Xu, Xu, Xu, Xu, Xu, Xu, Xu, Xu, Xu, Xu, Xu, Xu, Xu, Xu, Xu, Xu, Xu, Xu, Xu, Rrc, Rrc, Rrc, Xu, Xu, Xu, Xu, Xu, Xu, Xu, Xu, Xu, Xu, Xu, Xu, Xu, Xu, Xu, Xu, Xu, Xu, Xu, Xu, Xu
