Dd, Dd, Dd, Dd, Dd, Dd, Dd, Dd, Dd, Dd, Dd, Dd, Dd, Dd, Dd, Dd, Dd, Gd, Gd, Gd, Gs, Gd, Gd, Gd, Gd, Gd, Hhd, Hhd, Hhd, Gd, Gll^Fdf, Gd, Gd, Gs, Gs, Gs, Gs, Gd, Hh, Hh, Hh, Gg, Mm, Mm, Mm, Gg, Mm, Mm, Mm^Xm, Mm, Mm^Xm, Mm
Dd, Dd, Dd, Dd, Dd, Dd, Dd, Dd, Dd, Dd, Dd, Dd, Dd^Vdt, Dd, Dd, Dd, Gd, Gd, Gd, Gd, Gd, Gd, Hhd, Gd, Md, Md^Xm, Md, Md, Md, Gll^Fdf, Gll^Fdf, Gll^Fdf, Gd, Gd, Gd, Gd, Gll^Fdf, Gd, Hh, Hh, Hh, Hh, Mm^Xm, Mm, Mm, Mm, Mm, Mm^Xm, Mm^Xm, Mm^Xm, Mm, Mm
Dd, Dd, Dd, Dd^Vdt, Dd, Dd, Dd, Dd, Dd, Dd, Md, Dd, Dd, Dd, Hhd, Hhd, Md, Gs, Md, Gd, Dd^Vdt, Dd, Md, Hhd, Md, Md, Md, Md, Md, Hhd, Hhd, Gd, Gd, Gd, Gll^Fdf, Gll^Fdf, Gll^Fdf, Hh, Hh, Hh, Mm, Mm, Mm, Mm^Xm, Mm^Xm, Mm, Mm, Mm, Mm, Mm^Xm, Mm, Mm
Dd, Dd, Dd, Dd, Dd, Dd, Dd, Dd, Hd, Hd, Dd, Dd, Dd, Md, Md, Md, Md, Hhd, Hhd, Dd, Md^Xm, Hhd, Md, Md, Hhd, Hd, Md, Md, Md, Md, Md, Md, Gd, Gd, Gd, Gll^Fdf, Gll^Fdf, Hh, Mm, Mm^Xm, Mm^Xm, Mm, Mm, Mm, Mm, Mm, Mm^Xm, Mm^Xm, Mm, Mm, Mm, Mm
Dd, Dd, Md, Dd, Hhd, Hd, Hd, Md, Md, Md, Hhd, Dd, Md, Md, Hhd, Hhd, Dd^Vdt, Md, Hhd, Md, Md, Md^Xm, Md^Xm, Hhd, Md, Hd, Md, Gll^Fdf, Hhd, Hhd, Md, Md, Gd, Gd, Gll^Fdf, Gll^Fdf, Hh, Hh, Mm, Mm, Mm, Mm^Xm, Mm, Mm, Mm, Mm^Xm, Mm, Mm, Mm, Mm, Mm, Mm
Dd, Dd, Dd, Hhd, Md, Md^Xm, Md, Md, Md, Md, Hhd, Hhd, Md^Xm, Md, Gll^Fdf, Gll^Fdf, Cdr, Hhd, Gll^Fdf, Md, Md, Md, Md, Md, Md, Md, Hd, Gll^Fdf, Hhd, Md, Gll^Fdf, Gs, Gd, Gd, Gll^Fdf, Hh, Hh, Mm, Mm, Mm, Mm, Mm, Mm, Mm, Mm^Xm, Mm, Mm^Xm, Mm, Mm^Xm, Mm^Xm, Mm^Xm, Mm^Xm
Dd, Dd, Hhd, Hd, Hd, Md, Hd, Md, Hhd, Md, Md, Md, Md, Md, Gll^Fdf, Cdr, 4 Kdr, Cdr, Gll^Fdf, Gll^Fdf, Md, Md, Md, Md, Hhd, Hd, Gd, Dd^Vdt, Gs, Gll^Fdf, Gll^Fdf, Gll^Fdf, Gd, Hh, Hh, Hh, Mm, Mm, Mm^Xm, Mm, Mm^Xm, Mm, Xu, Mm^Xm, Xu, Mm^Xm, Xu, Mm^Xm, Xu, Mm^Xm, Xu, Xu
Hhd, Md, Hhd, Dd, Dd, Hd, Dd, Hhd, Md, Md, Hhd, Md, Md, Md, Md, Cdr, Cdr, Cdr, Md, Md, Hhd, Hhd, Hd, Hhd, Gd, Gd, Gd, Gd, Gd, Gd, Gs, Gd, Gd, Hh, Hh, Hh, Mm^Xm, Mm^Xm, Mm^Xm, Mm^Xm, Xu, Xos, Xos, Xu, Xu, Xu, Xos, Xos, Xos, Xu, Xu, Xu
Hhd, Dd, Dd, Dd, Dd, Dd, Hd, Md, Md, Md, Md, Hhd, Md, Md, Hhd, Hhd, Dd, Gll^Fdf, Dd, Hhd, Gs, Gs, Gll^Fdf, Gll^Fdf, Gs, Gd, Md, Md, Gd, Gd, Gll^Fdf, Gll^Fdf, Hh, Hhd, Hh, Mm^Xm, Xu, Xu, Xu, Xu, Xos, Xos, Uu, Uu, Uu, Xos, Cud, Cud, Cud, Xos, Xos, Xu
Md, Dd, Dd, Dd, Hd, Hd, Md, Md, Hd, Md, Md, Md, Md, Hhd, Gll^Fdf, Gll^Fdf, Hhd, Dd, Gd, Gd, Hhd, Gd, Md^Xm, Gll^Fdf, Md, Md, Hhd, Md, Gs, Gs, Gd, Hh, Hh, Hhd, Hhd, Hhd, Uh, Xu, Uu, Xos, Uu, Uu, Ur, Ur, Uh, Cud, Cud, 2 Kud, Cud, Uu, Uu, Uu
Dd, Dd, Dd, Dd, Hd, Md, Dd, Hd, Dd, Hd, Gs, Gs, Gd, Gs, Gd, Gll^Fdf, Md, Hhd, Gd, Md, Md, Md, Md, Md, Md, Md, Md, Md, Gll^Fdf, Gd, Gs, Hh, Hhd, Hhd, Hh, Uh, Uh, Uu, Cud, Uu, Uu, Uu, Uu^Vud, Ur, Ur, Cud, Cud, Cud, Ur, Ur, Uu, Uu
Dd, Dd, Cdr^Vdr, Dd, Cdr^Vdr, Dd, Dd, Dd, Dd, Gd, Gd, Gd, Gd, Gs, Gd, Md, Dd, Dd, Dd^Vdt, Hhd, Gs, Hhd, Hhd, Hhd, Hd, Hhd, Gll^Fdf, Gll^Fdf, Gd, Gll^Fdf, Hh, Gs, Hhd, Hh, Hhd, Hhd, Uu, Uu^Dr, Ur, Ur, Uu, Ur, Ur, Ur, Ur, Ur, Ur, Uu, Ur, Uu, Uu, Uu
Dd, Dd, Cdr, Cdr, Cdr, Dd, Dd, Dd, Dd, Gd, Md, Md, Md, Gd, Md, Hhd, Hd, Hd, Hhd, Gd, Gd, Gd, Md, Hd, Hhd, Gll^Fdf, Gll^Fdf, Gs, Gd, Gll^Fdf, Hh, Hhd, Hhd, Hhd, Hhd, Uh, Uu^Dr, Uu^Dr, Uu^Dr, Uu^Dr, Ur, Uu, Ur, Ur, Uu, Ur, Ur, Uu, Ur, Uu, Ur, Uu
Dd, Cdr^Vdr, Cdr, 3 Kdr, Cdr, Cdr^Vdr, Dd, Dd, Gd, Gd, Md, Hd, Hd, Hd, Gll^Fdf, Md, Md, Md, Hhd, Gd, Md, Md, Md, Gll^Fdf, Md, Hhd, Md, Gd, Gd, Gd, Hh, Hhd, Hhd, Hh, Uh, Uh, Uu, Uu^Dr, Urb^Dr, Ur, Ur, Ur, Ur, Ur, Uu, Uu, Ur, Uu^Vud, Ur, Uu, Ur, Ur
Dd, Dd, Cdr^Vdr, Cdr, Cdr^Vdr, Dd, Dd, Hhd, Hhd, Md, Gd, Md, Md, Md, Gll^Fdf, Dd, Dd^Vdt, Hd, Gll^Fdf, Gll^Fdf, Dd^Vdt, Hhd, Hhd, Md, Hd, Md, Gd, Gd, Gd, Gll^Fdf, Gll^Fdf, Hh, Hhd, Hh, Hhd, Uh, Uu^Dr, Cud^Dr, Uu^Dr, Uu, Uu^Dr, Uu^Vud, Uu, Uu, Cud, Ur, Uu, Uu, Uu, Uu, Uu, Uu
Dd, Dd, Dd, Dd, Md, Hhd, Hhd, Md, Gs, Gs, Hhd, Md, Md, Md^Xm, Md^Xm, Gll^Fdf, Md, Gd, Md, Gll^Fdf, Md, Md, Gll^Fdf, Hhd, Gll^Fdf, Gd, Gs, Gll^Fdf, Gd, Gs, Gd, Hhd, Hhd, Hhd, Hh, Uu^Dr, Uu^Dr, Uu^Dr, Uu^Dr, Uu^Dr, Uu^Dr, Uu^Dr, Ur, Cud, 1 Kud, Cud, Ur, Ur, Uu, Uu, Xu, Xu
Dd, Dd, Dd, Dd, Hd, Md, Gd, Md, Hhd, Md, Hhd, Gll^Fdf, Hhd, Md^Xm, Md, Md, Md, Md, Md, Md, Gll^Fdf, Gll^Fdf, Hd, Gll^Fdf, Gll^Fdf, Gd, Gs, Gll^Fdf, Gll^Fdf, Gd, Gs, Hhd, Hhd, Hh, Hhd, Uh, Uh^Dr, Uu^Dr, Uu^Dr, Cud, Uu, Ur, Ur, Cud, Cud, Cud, Uu, Uu, Xu, Xu, Xu, Xu
Dd, Dd, Dd, Dd, Hd, Hd, Hhd, Gs, Md, Md, Gll^Fdf, Gll^Fdf, Hd, Md, Hhd, Md, Hhd, Md, Md, Md^Xm, Md, Md, Hd, Md, Md, Gd, Gll^Fdf, Gd, Gd, Gd, Gd, Hhd, Hh, Hh, Hh, Uh, Xu, Xos, Xos, Uu, Xos, Uu, Xos, Xos, Xos, Xos, Xu, Xu, Xu, Xu, Mm^Xm, Mm^Xm
Dd, Dd, Dd, Dd, Md, Md, Hhd, Gll^Fdf, Hd, Hhd, Md, Hd, Hd, Hhd, Gll^Fdf, Hhd, Hd, Gll^Fdf, Hhd, Hhd, Cdr, Hhd, Md, Md, Hd, Gd, Gd, Gs, Gd, Gd, Gs, Gd^Fdf, Hh^Fdf, Hh, Mm, Mm^Xm, Mm^Xm, Xu, Xu, Xu, Xu, Xu, Xu, Xu, Xu, Xu, Mm^Xm, Xu, Mm^Xm, Mm^Xm, Mm, Mm
Dd, Dd, Dd^Vdt, Dd, Md, Md, Gll^Fdf, Gll^Fdf, Hd, Md, Md, Md, Gs, Gd, Gll^Fdf, Gll^Fdf, Md, Hd, Md, Cdr, 5 Kdr, Cdr, Md, Hd, Md, Md, Gs, Gd, Gd, Gd, Gd^Fdf, Hh^Fdf, Hh^Fdf, Hh, Mm, Mm^Xm, Mm, Mm^Xm, Mm^Xm, Xu, Mm^Xm, Xu, Mm^Xm, Mm^Xm, Mm^Xm, Mm^Xm, Mm^Xm, Mm^Xm, Mm^Xm, Mm^Xm, Mm, Mm
Dd, Dd, Hd, Hhd, Hhd, Hd, Hhd, Md, Hhd, Md, Hd, Hd, Gs, Gd, Gd, Dd^Vdt, Dd, Md, Gll^Fdf, Cdr, Cdr, Cdr, Gll^Fdf, Md, Dd^Vdt, Gs, Gs, Gd, Gd, Gs, Gd, Hh^Fdf, Hh^Fdf, Hh, Hh, Mm, Mm, Mm^Xm, Mm, Mm^Xm, Mm^Xm, Mm^Xm, Mm^Xm, Mm^Xm, Mm^Xm, Mm, Mm^Xm, Mm^Xm, Mm, Mm, Mm^Xm, Mm
Dd, Dd, Dd, Hd, Gd, Gll^Fdf, Gd, Hhd, Gd, Gll^Fdf, Gll^Fdf, Gs, Gd, Gd, Gd, Gd, Gd, Gll^Fdf, Gll^Fdf, Gll^Fdf, Gll^Fdf, Gll^Fdf, Gd, Dd, Gs, Gd, Gs, Gd, Gd, Gs, Gd, Gd, Gs, Hh, Gg, Mm, Mm, Mm, Gg, Mm^Xm, Mm, Mm, Mm, Mm^Xm, Mm^Xm, Mm, Mm, Mm, Mm, Mm, Mm, Mm
