Xu, Xu, Xu, Xu, Xu, Xu, Uh, Uu, Uu, Xu, Xu, Xu, Xu, Xu, Xu, Xu, Xu, Xu, Xu, Xu, Xu, Xu, Xu, Xu, Xu, Wog, Wog, Xu, Xu, Xu, Xu, Xu, Xu, Xu, Xu, Xu, Xu, Xu, Xu, Xu, Xu, Xu, Xu, Xu, Xu, Xu, Xu
Xu, Xu, Xu, Xu, Xu, Xu, Uh, Uu, Tb^Tf, Tb^Tf, Xu, Xu, Xu, Xu, Xu, Xu, Xu, Xu, Xu, Xu, Xu, Xu, Xu, Xu, Wog, Wog, Wog, Xu, Xu, Xu, Xu, Xu, Xu, Xu, Xu, Xu, Xu, Xu, Xu, Xu, Xu, Xu, Xu, Xu, Xu, Xu, Xu
Xu, Xu, Xu, Xu, Xu, Xu, Xu, Uh, Uu, Tb^Tf, Uh, Xu, Xu, Xu, Xu, Xu, Xu, Xu, Xu, Xu, Xu, Xu, Xu, Xu, Wog, Wog, Xu, Xu, Xu, Xu, Xu, Xu, Xu, Xu, Xu, Xu, Xu, Xu, Xu, Xu, Xu, Xu, Xu, Xu, Xu, Xu, Xu
Xu, Xu, Xu, Xu, Xu, Xu, Xu, Xu, Rb, Uh, Uu, Xu, Xu, Xu, Xu, Xu, Xu, Xu, Xu, Xu, Xu, Xu, Xu, Xu, Wog, Wog, Xu, Xu, Xu, Xu, Xu, Xu, Xu, Xu, Xu, Xu, Xu, Xu, Xu, Xu, Xu, Xu, Xu, Xu, Xu, Xu, Xu
Xu, Xu, Xu, Xu, Xu, Xu, Xu, Xu, Tb^Tf, Rb, Uh, Tb^Tf, Xu, Xu, Xu, Xu, Xu, Xu, Xu, Xu, Xu, Xu, Uu, Wwg, Wwg, Wwg, Uu, Uu, Uh, Xu, Xu, Xu, Xu, Xu, Xu, Xu, Xu, Xu, Xu, Xu, Xu, Xu, Xu, Xu, Xu, Xu, Xu
Xu, Xu, Xu, Xu, Xu, Xu, Xu, Xu, Xu, Rb, Uh, Tb^Tf, Tb^Tf, Xu, Xu, Xu, Xu, Xu, Uh, Xu, Xu, Xu, Wwg, Wwg, Wog, Wwg, Uh, Uu^Vu, Tb^Tf, Xu, Xu, Xu, Xu, Xu, Xu, Xu, Uh, Xu, Tb^Tf, Tb^Tf, Tb^Tf, Xu, Uu, Xu, Xu, Xu, Xu
Xu, Xu, Xu, Xu, Xu, Xu, Xu, Xu, Xu, Uh, Uu, Uu, Co, Uh, Uu, Uu, Tb^Tf, Uh, Uh, Uu, Uu, Uu, Wwg, Wog, Wwg, Uh, Xu, Tb^Tf, Xu, Xu, Xu, Xu, Xu, Xu, Xu, Xu, Uh, Uh, Uu^Vu, Uh, Uh, Uu, Tb^Tf, Xu, Xu, Xu, Xu
Xu, Xu, Xu, Xu, Xu, Xu, Xu, Xu, Xu, Xu, Tb^Tf, Co, Ko, Uh, Uh, Uu^Vu, Tb^Tf, Uu, Uh, Urb, Tb^Tf, Tb^Tf, Wwg, Wog, Wwg, Uu, Xu, Xu, Xu, Xu, Xu, Xu, Xu, Xu, Xu, Xu, Urb, Uu, Uu, Uh, Ur, Uu, Uh, Tb^Tf, Xu, Xu, Xu
Xu, Xu, Xu, Xu, Xu, Xu, Xu, Xu, Xu, Xu, Tb^Tf, Tb^Tf, Co, Co, Ur, Tb^Tf, Uu, Uu, Uh, Urb, Uh, Uh, Wwg, Wwg, Tb^Tf, Uu, Xu, Xu, Xu, Xu, Uh, Uh, Uh, Xu, Tb^Tf, Tb^Tf, Uu^Vu, Urb, Uu, Tb^Tf, Ur, Uu^Vu, Uh, Xu, Xu, Xu, Xu
Xu, Xu, Xu, Xu, Uh, Uh, Xu, Xu, Xu, Uh, Uh, Uu^Vu, Uu, Uh, Ur, Uh, Uh, Tb^Tf, Co, Co, Co, Wwg, Wog, Wwg, Tb^Tf, Ur, Ur, Xu, Xu, Xu, Tb^Tf, Uu^Vu, Rb, Rb, Rb, Tb^Tf, Uu, Urb, Uh, Ur, Tb^Tf, Uh, Xu, Xu, Xu, Xu, Xu
Xu, Xu, Xu, Xu, Uh, Uu, Uu, Xu, Xu, Uh, Tb^Tf, Tb^Tf, Uu, Ur, Tb^Tf, Tb^Tf, Uh, Uu, Co, Ko, Wwg, Wwg, Wog, Wwg, Co, Co, Co, Uh, Uh, Uh, Tb^Tf, Tb^Tf, Uh, Uh, Uh, Uu, Uu, Uh, Ur, Tb^Tf, Ur, Tb^Tf, Xu, Xu, Xu, Xu, Xu
Uh, Xu, Tb^Tf, Uu, Tb^Tf, Urb, Tb^Tf, Xu, Xu, Xu, Xu, Xu, Xu, Uu, Uh, Uu^Vu, Uu, Uu, Wwf, Uh, Wwf, Wwg, Wwg, Wwg, Wwf, Ko, Co, Tb^Tf, Tb^Tf, Uu, Uu, Ur, Ur, Ur, Uu^Vu, Tb^Tf, Ur, Ur, Uu, Uu, Uu, Ur, Xu, Xu, Xu, Xu, Xu
Uh, Rb, Rb, Tb^Tf, Xu, Urb, Uh, Tb^Tf, Ur, Xu, Xu, Xu, Xu, Uh, Uu, Uh, Wwg, Wwg, Wwg, Wwf, Wwg, Wwg, Wog, Wwg, Wwg, Wwf, Uu, Uh, Urb, Uu^Vu, Uh, Uh, Uh, Uu, Uh, Uh, Tb^Tf, Uh, Tb^Tf, Tb^Tf, Uu^Vu, Ur, Xu, Xu, Xu, Xu, Xu
Xu, Uh, Xu, Xu, Xu, Xu, Uh, Ur, Tb^Tf, Xu, Xu, Xu, Tb^Tf, Tb^Tf, Uu, Ur, Wwg, Wog, Wog, Wwg, Wog, Wog, Wog, Wwg, Wwg, Wwg, Tb^Tf, Uu, Uh, Urb, Tb^Tf, Uu, Uu, Tb^Tf, Uu, Tb^Tf, Uu, Uh, Uh, Ur, Ur, Uu, Uu, Xu, Xu, Xu, Xu
Xu, Xu, Xu, Xu, Xu, Xu, Xu, Uh, Uu, Tb^Tf, Uh, Xu, Tb^Tf, Uu, Co, Uu^Vu, Uh, Wwg, Wwg, Wwg, Wog, Wog, Wog, Wog, Wwg, Wwf, Uh, Tb^Tf, Uh, Uh, Tb^Tf, Tb^Tf, Rb, Uh, Uh, Tb^Tf, Uu, Ur, Tb^Tf, Tb^Tf, Uh, Uh, Tb^Tf, Xu, Xu, Xu, Xu
Xu, Xu, Xu, Xu, Xu, Xu, Xu, Rb, Rb, Tb^Tf, Uh, Urb, Urb, Co, Ko, Co, Uh, Wwf, Wwf, Wwg, Wwg, Wog, Wwg, Wwg, Wwf, Wwf, Uh, Tb^Tf, Co, Uu^Vu, Uu, Rb, Tb^Tf, Rb, Tb^Tf, Uu, Uh, Uh, Xu, Xu, Uu, Uh, Tb^Tf, Xu, Xu, Xu, Xu
Xu, Xu, Xu, Xu, Xu, Xu, Xu, Xu, Xu, Uh, Xu, Uu, Uu, Co, Co, Co, Uu, Uh, Wwf, Wwg, Wwg, Wwg, Wwg, Wwg, Tb^Tf, Uh, Uu^Vu, Co, 2 Ko, Co, Tb^Tf, Uu, Ur, Tb^Tf, Uu, Ur, Uh, Tb^Tf, Xu, Xu, Xu, Tb^Tf, Xu, Xu, Xu, Xu, Xu
Xu, Xu, Xu, Xu, Xu, Xu, Xu, Xu, Xu, Xu, Xu, Xu, Uu, Tb^Tf, Tb^Tf, Tb^Tf, Uu, Uu, Tb^Tf, Wwg, Uh, Wwf, Wwf, Wwf, Tb^Tf, Uu, Uu, Co, Co, Co, Tb^Tf, Uu, Uh, Uu, Tb^Tf, Ur, Ur, Tb^Tf, Qxu, Xu, Xu, Xu, Xu, Xu, Xu, Xu, Xu
Xu, Xu, Xu, Xu, Xu, Xu, Xu, Xu, Xu, Xu, Xu, Xu, Xu, Uh, Uh, Ur, Ur, Uh, Uh, Tb^Tf, Uh, Uh, Uu, Rb, Rb, Rb, Uu, Uh, Uh, Uh, Urb, Uh, Tb^Tf, Uu, Uh, Uu^Vu, Uu, Qxu, Qxu, Qxu, Xu, Xu, Xu, Xu, Xu, Xu, Xu
Xu, Xu, Xu, Xu, Xu, Xu, Xu, Xu, Xu, Xu, Xu, Xu, Xu, Uh, Tb^Tf, Uu, Uh, Uu^Vu, Uu, Uu, Rb, Uu, Ur, Uu^Vu, Uu, Tb^Tf, Tb^Tf, Ur, Rb, Uu, Uu, Urb, Tb^Tf, Uh, Uh, Uu, Qxu, Qxu, Qxu, Qxu, Xu, Xu, Xu, Xu, Xu, Xu, Xu
Xu, Xu, Xu, Xu, Xu, Xu, Xu, Xu, Xu, Xu, Xu, Xu, Xu, Tb^Tf, Uu, Uu, Uh, Tb^Tf, Tb^Tf, Rb, Tb^Tf, Uu, Rb, Ur, Uu, Uh, Uh, Rb, Tb^Tf, Tb^Tf, Uh, Uu^Vu, Uu, Tb^Tf, Ko, Co, Qxu, Qxu, Qxu, Xu, Xu, Xu, Xu, Xu, Xu, Xu, Xu
Xu, Xu, Xu, Xu, Qxu, Qxu, Qxu, Xu, Xu, Xu, Qxu, Xu, Uh, Tb^Tf, Urb, Urb, Co, Uh, Uu, Ur, Tb^Tf, Tb^Tf, Uh, Uu, Tb^Tf, Uh, Uu^Vu, Uu, Uu, Uh, Uh, Tb^Tf, Uu, Co, Co, Co, Tb^Tf, Qxu, Xu, Xu, Xu, Xu, Xu, Xu, Uh, Xu, Uu
Qxu, Xu, Qxu, Qxu, Qxu, Qxu, Qxu, Qxu, Qxu, Qxu, Qxu, Tb^Tf, Tb^Tf, Uh, Uu^Vu, Co, Ko, Co, Uu, Uu, Uu^Vu, Uh, Ur, Tb^Tf, Co, Co, Co, Urb, Co, Tb^Tf, Qxu, Qxu, Qxu, Uu, Ur, Ur, Tb^Tf, Xu, Xu, Xu, Uh, Tb^Tf, Uu, Uh, Tb^Tf, Uu, Ur
Qxu, Qxu, Qxu, Qxu, Qxu, Xu, Xu, Qxu, Qxu, Qxu, Uh, Tb^Tf, Co, Uh, Urb, Co, Co, Co, Urb, Urb, Urb, Uh, Ur, Tb^Tf, Co, Ko, Co, Urb, Tb^Tf, Tb^Tf, Qxu, Qxu, Qxu, Xu, Xu, Uu, Urb, Xu, Xu, Xu, Rb, Tb^Tf, Uu, Uh, Urb, Tb^Tf, Ur
Qxu, Qxu, Qxu, Qxu, Xu, Xu, Uh, Tb^Tf, Urb, Uu, Uu, Uh, Ur, Uu, Urb, Uu, Tb^Tf, Uu, Uh, Uh, Tb^Tf, Tb^Tf, Uu, Ur, Uh, Co, Uu, Uu, Qxu, Qxu, Qxu, Qxu, Xu, Xu, Xu, Uu, Co, Uh, Uu, Uh, Uh, Rb, Xu, Urb, Xu, Uu, Xu
Xu, Xu, Xu, Xu, Xu, Tb^Tf, Uh, Urb, Tb^Tf, Urb, Uu, Uu^Vu, Ur, Uh, Uh, Tb^Tf, Tb^Tf, Ur, Ur, Ur, Xu, Xu, Uu, Co, Uh, Uu, Uh, Uh, Qxu, Qxu, Qxu, Xu, Xu, Xu, Xu, Tb^Tf, Tb^Tf, Ur, Ur, Uh, Tb^Tf, Xu, Xu, Xu, Xu, Xu, Xu
Xu, Xu, Xu, Xu, Tb^Tf, Uh, Ur, Tb^Tf, Xu, Xu, Xu, Uh, Tb^Tf, Ur, Uu, Co, Uu^Vu, Uh, Uh, Xu, Xu, Xu, Xu, Uu, Urb, Urb, Uh, Xu, Xu, Qxu, Xu, Xu, Xu, Xu, Xu, Xu, Xu, Xu, Xu, Tb^Tf, Xu, Xu, Xu, Xu, Xu, Xu, Xu
Xu, Xu, Xu, Tb^Tf, Tb^Tf, Ur, Uh, Uh, Xu, Xu, Xu, Tb^Tf, Uh, Uh, Xu, Uu, Tb^Tf, Tb^Tf, Xu, Xu, Xu, Xu, Xu, Xu, Tb^Tf, Uu, Xu, Xu, Xu, Xu, Xu, Xu, Xu, Xu, Xu, Xu, Xu, Xu, Xu, Xu, Xu, Xu, Xu, Xu, Xu, Xu, Xu
Xu, Xu, Uu, Uu, Uu, Ur, Xu, Xu, Xu, Xu, Xu, Xu, Xu, Xu, Xu, Xu, Xu, Xu, Xu, Xu, Xu, Xu, Xu, Xu, Tb^Tf, Rb, Xu, Xu, Xu, Xu, Xu, Xu, Xu, Xu, Xu, Xu, Xu, Xu, Xu, Xu, Xu, Xu, Xu, Xu, Xu, Xu, Xu
Tb^Tf, Tb^Tf, 1 Urb, Urb, Uh, Tb^Tf, Xu, Xu, Xu, Xu, Xu, Xu, Xu, Xu, Xu, Xu, Xu, Xu, Xu, Xu, Xu, Xu, Xu, Xu, Uh, Uh, Uu, Xu, Xu, Xu, Xu, Xu, Xu, Xu, Xu, Xu, Xu, Xu, Xu, Xu, Xu, Xu, Xu, Xu, Xu, Xu, Xu
Uu, Tb^Tf, Urb, Uh, Xu, Xu, Xu, Xu, Xu, Xu, Xu, Xu, Xu, Xu, Xu, Xu, Xu, Xu, Xu, Xu, Xu, Xu, Xu, Xu, Xu, Tb^Tf, Ur, Uh, Xu, Xu, Xu, Xu, Xu, Xu, Xu, Xu, Xu, Xu, Xu, Xu, Xu, Xu, Xu, Xu, Xu, Xu, Xu
Uu, Uu, Uu, Uh, Xu, Xu, Xu, Xu, Xu, Xu, Xu, Xu, Xu, Xu, Xu, Xu, Xu, Xu, Xu, Xu, Xu, Xu, Xu, Xu, Xu, Xu, Ur, Uh, Xu, Xu, Xu, Xu, Xu, Xu, Xu, Xu, Xu, Xu, Xu, Xu, Xu, Xu, Xu, Xu, Xu, Xu, Xu
