border_size=1
usage=map

Xu, Xu, Xu, Xu, Xu, Xu, Uh, Uu, Uu, Xu, Xu, Xu, Xu, Xu, Xu, Xu, Xu, Xu, Xu, Xu, Xu, Xu, Xu, Xu, Xu, Wog, Wog, Xu, Xu, Xu, Xu, Xu, Xu, Xu, Xu, Xu, Xu, Xu, Xu, Xu, Xu, Xu, Xu, Xu, Xu, Xu, Xu
Xu, Xu, Xu, Xu, Xu, Xu, Uh, Uu, Uu^Uf, Uu^Uf, Xu, Xu, Xu, Xu, Xu, Xu, Xu, Xu, Xu, Xu, Xu, Xu, Xu, Xu, Wog, Wog, Wog, Xu, Xu, Xu, Xu, Xu, Xu, Xu, Xu, Xu, Xu, Xu, Xu, Xu, Xu, Xu, Xu, Xu, Xu, Xu, Xu
Xu, Xu, Xu, Xu, Xu, Xu, Xu, Uh, Uu, Uu^Uf, Uh, Xu, Xu, Xu, Xu, Xu, Xu, Xu, Xu, Xu, Xu, Xu, Xu, Xu, Wog, Wog, Xu, Xu, Xu, Xu, Xu, Xu, Xu, Xu, Xu, Xu, Xu, Xu, Xu, Xu, Xu, Xu, Xu, Xu, Xu, Xu, Xu
Xu, Xu, Xu, Xu, Xu, Xu, Xu, Xu, Rb, Uh, Uu, Xu, Xu, Xu, Xu, Xu, Xu, Xu, Xu, Xu, Xu, Xu, Xu, Xu, Wog, Wog, Xu, Xu, Xu, Xu, Xu, Xu, Xu, Xu, Xu, Xu, Xu, Xu, Xu, Xu, Xu, Xu, Xu, Xu, Xu, Xu, Xu
Xu, Xu, Xu, Xu, Xu, Xu, Xu, Xu, Uu^Uf, Rb, Uh, Uu^Uf, Xu, Xu, Xu, Xu, Xu, Xu, Xu, Xu, Xu, Xu, Uu, Wwg, Wwg, Wwg, Uu, Uu, Uh, Xu, Xu, Xu, Xu, Xu, Xu, Xu, Xu, Xu, Xu, Xu, Xu, Xu, Xu, Xu, Xu, Xu, Xu
Xu, Xu, Xu, Xu, Xu, Xu, Xu, Xu, Xu, Rb, Uh, Uu^Uf, Uu^Uf, Xu, Xu, Xu, Xu, Xu, Uh, Xu, Xu, Xu, Wwg, Wwg, Wog, Wwg, Uh, Uu^Vu, Uu^Uf, Xu, Xu, Xu, Xu, Xu, Xu, Xu, Uh, Xu, Uu^Uf, Uu^Uf, Uu^Uf, Xu, Uu, Xu, Xu, Xu, Xu
Xu, Xu, Xu, Xu, Xu, Xu, Xu, Xu, Xu, Uh, Uu, Uu, Co, Uh, Uu, Uu, Uu^Uf, Uh, Uh, Uu, Uu, Uu, Wwg, Wog, Wwg, Uh, Xu, Uu^Uf, Xu, Xu, Xu, Xu, Xu, Xu, Xu, Xu, Uh, Uh, Uu^Vu, Uh, Uh, Uu, Uu^Uf, Xu, Xu, Xu, Xu
Xu, Xu, Xu, Xu, Xu, Xu, Xu, Xu, Xu, Xu, Uu^Uf, Co, Ko, Uh, Uh, Uu^Vu, Uu^Uf, Uu, Uh, Urb, Uu^Uf, Uu^Uf, Wwg, Wog, Wwg, Uu, Xu, Xu, Xu, Xu, Xu, Xu, Xu, Xu, Xu, Xu, Urb, Uu, Uu, Uh, Ur, Uu, Uh, Uu^Uf, Xu, Xu, Xu
Xu, Xu, Xu, Xu, Xu, Xu, Xu, Xu, Xu, Xu, Uu^Uf, Uu^Uf, Co, Co, Ur, Uu^Uf, Uu, Uu, Uh, Urb, Uh, Uh, Wwg, Wwg, Uu^Uf, Uu, Xu, Xu, Xu, Xu, Uh, Uh, Uh, Xu, Uu^Uf, Uu^Uf, Uu^Vu, Urb, Uu, Uu^Uf, Ur, Uu^Vu, Uh, Xu, Xu, Xu, Xu
Xu, Xu, Xu, Xu, Uh, Uh, Xu, Xu, Xu, Uh, Uh, Uu^Vu, Uu, Uh, Ur, Uh, Uh, Uu^Uf, Co, Co, Co, Wwg, Wog, Wwg, Uu^Uf, Ur, Ur, Xu, Xu, Xu, Uu^Uf, Uu^Vu, Rb, Rb, Rb, Uu^Uf, Uu, Urb, Uh, Ur, Uu^Uf, Uh, Xu, Xu, Xu, Xu, Xu
Xu, Xu, Xu, Xu, Uh, Uu, Uu, Xu, Xu, Uh, Uu^Uf, Uu^Uf, Uu, Ur, Uu^Uf, Uu^Uf, Uh, Uu, Co, Ko, Wwg, Wwg, Wog, Wwg, Co, Co, Co, Uh, Uh, Uh, Uu^Uf, Uu^Uf, Uh, Uh, Uh, Uu, Uu, Uh, Ur, Uu^Uf, Ur, Uu^Uf, Xu, Xu, Xu, Xu, Xu
Uh, Xu, Uu^Uf, Uu, Uu^Uf, Urb, Uu^Uf, Xu, Xu, Xu, Xu, Xu, Xu, Uu, Uh, Uu^Vu, Uu, Uu, Wwf, Uh, Wwf, Wwg, Wwg, Wwg, Wwf, Ko, Co, Uu^Uf, Uu^Uf, Uu, Uu, Ur, Ur, Ur, Uu^Vu, Uu^Uf, Ur, Ur, Uu, Uu, Uu, Ur, Xu, Xu, Xu, Xu, Xu
Uh, Rb, Rb, Uu^Uf, Xu, Urb, Uh, Uu^Uf, Ur, Xu, Xu, Xu, Xu, Uh, Uu, Uh, Wwg, Wwg, Wwg, Wwf, Wwg, Wwg, Wog, Wwg, Wwg, Wwf, Uu, Uh, Urb, Uu^Vu, Uh, Uh, Uh, Uu, Uh, Uh, Uu^Uf, Uh, Uu^Uf, Uu^Uf, Uu^Vu, Ur, Xu, Xu, Xu, Xu, Xu
Xu, Uh, Xu, Xu, Xu, Xu, Uh, Ur, Uu^Uf, Xu, Xu, Xu, Uu^Uf, Uu^Uf, Uu, Ur, Wwg, Wog, Wog, Wwg, Wog, Wog, Wog, Wwg, Wwg, Wwg, Uu^Uf, Uu, Uh, Urb, Uu^Uf, Uu, Uu, Uu^Uf, Uu, Uu^Uf, Uu, Uh, Uh, Ur, Ur, Uu, Uu, Xu, Xu, Xu, Xu
Xu, Xu, Xu, Xu, Xu, Xu, Xu, Uh, Uu, Uu^Uf, Uh, Xu, Uu^Uf, Uu, Co, Uu^Vu, Uh, Wwg, Wwg, Wwg, Wog, Wog, Wog, Wog, Wwg, Wwf, Uh, Uu^Uf, Uh, Uh, Uu^Uf, Uu^Uf, Rb, Uh, Uh, Uu^Uf, Uu, Ur, Uu^Uf, Uu^Uf, Uh, Uh, Uu^Uf, Xu, Xu, Xu, Xu
Xu, Xu, Xu, Xu, Xu, Xu, Xu, Rb, Rb, Uu^Uf, Uh, Urb, Urb, Co, Ko, Co, Uh, Wwf, Wwf, Wwg, Wwg, Wog, Wwg, Wwg, Wwf, Wwf, Uh, Uu^Uf, Co, Uu^Vu, Uu, Rb, Uu^Uf, Rb, Uu^Uf, Uu, Uh, Uh, Xu, Xu, Uu, Uh, Uu^Uf, Xu, Xu, Xu, Xu
Xu, Xu, Xu, Xu, Xu, Xu, Xu, Xu, Xu, Uh, Xu, Uu, Uu, Co, Co, Co, Uu, Uh, Wwf, Wwg, Wwg, Wwg, Wwg, Wwg, Uu^Uf, Uh, Uu^Vu, Co, 2 Ko, Co, Uu^Uf, Uu, Ur, Uu^Uf, Uu, Ur, Uh, Uu^Uf, Xu, Xu, Xu, Uu^Uf, Xu, Xu, Xu, Xu, Xu
Xu, Xu, Xu, Xu, Xu, Xu, Xu, Xu, Xu, Xu, Xu, Xu, Uu, Uu^Uf, Uu^Uf, Uu^Uf, Uu, Uu, Uu^Uf, Wwg, Uh, Wwf, Wwf, Wwf, Uu^Uf, Uu, Uu, Co, Co, Co, Uu^Uf, Uu, Uh, Uu, Uu^Uf, Ur, Ur, Uu^Uf, Qxu, Xu, Xu, Xu, Xu, Xu, Xu, Xu, Xu
Xu, Xu, Xu, Xu, Xu, Xu, Xu, Xu, Xu, Xu, Xu, Xu, Xu, Uh, Uh, Ur, Ur, Uh, Uh, Uu^Uf, Uh, Uh, Uu, Rb, Rb, Rb, Uu, Uh, Uh, Uh, Urb, Uh, Uu^Uf, Uu, Uh, Uu^Vu, Uu, Qxu, Qxu, Qxu, Xu, Xu, Xu, Xu, Xu, Xu, Xu
Xu, Xu, Xu, Xu, Xu, Xu, Xu, Xu, Xu, Xu, Xu, Xu, Xu, Uh, Uu^Uf, Uu, Uh, Uu^Vu, Uu, Uu, Rb, Uu, Ur, Uu^Vu, Uu, Uu^Uf, Uu^Uf, Ur, Rb, Uu, Uu, Urb, Uu^Uf, Uh, Uh, Uu, Qxu, Qxu, Qxu, Qxu, Xu, Xu, Xu, Xu, Xu, Xu, Xu
Xu, Xu, Xu, Xu, Xu, Xu, Xu, Xu, Xu, Xu, Xu, Xu, Xu, Uu^Uf, Uu, Uu, Uh, Uu^Uf, Uu^Uf, Rb, Uu^Uf, Uu, Rb, Ur, Uu, Uh, Uh, Rb, Uu^Uf, Uu^Uf, Uh, Uu^Vu, Uu, Uu^Uf, Ko, Co, Qxu, Qxu, Qxu, Xu, Xu, Xu, Xu, Xu, Xu, Xu, Xu
Xu, Xu, Xu, Xu, Qxu, Qxu, Qxu, Xu, Xu, Xu, Qxu, Xu, Uh, Uu^Uf, Urb, Urb, Co, Uh, Uu, Ur, Uu^Uf, Uu^Uf, Uh, Uu, Uu^Uf, Uh, Uu^Vu, Uu, Uu, Uh, Uh, Uu^Uf, Uu, Co, Co, Co, Uu^Uf, Qxu, Xu, Xu, Xu, Xu, Xu, Xu, Uh, Xu, Uu
Qxu, Xu, Qxu, Qxu, Qxu, Qxu, Qxu, Qxu, Qxu, Qxu, Qxu, Uu^Uf, Uu^Uf, Uh, Uu^Vu, Co, Ko, Co, Uu, Uu, Uu^Vu, Uh, Ur, Uu^Uf, Co, Co, Co, Urb, Co, Uu^Uf, Qxu, Qxu, Qxu, Uu, Ur, Ur, Uu^Uf, Xu, Xu, Xu, Uh, Uu^Uf, Uu, Uh, Uu^Uf, Uu, Ur
Qxu, Qxu, Qxu, Qxu, Qxu, Xu, Xu, Qxu, Qxu, Qxu, Uh, Uu^Uf, Co, Uh, Urb, Co, Co, Co, Urb, Urb, Urb, Uh, Ur, Uu^Uf, Co, Ko, Co, Urb, Uu^Uf, Uu^Uf, Qxu, Qxu, Qxu, Xu, Xu, Uu, Urb, Xu, Xu, Xu, Rb, Uu^Uf, Uu, Uh, Urb, Uu^Uf, Ur
Qxu, Qxu, Qxu, Qxu, Xu, Xu, Uh, Uu^Uf, Urb, Uu, Uu, Uh, Ur, Uu, Urb, Uu, Uu^Uf, Uu, Uh, Uh, Uu^Uf, Uu^Uf, Uu, Ur, Uh, Co, Uu, Uu, Qxu, Qxu, Qxu, Qxu, Xu, Xu, Xu, Uu, Co, Uh, Uu, Uh, Uh, Rb, Xu, Urb, Xu, Uu, Xu
Xu, Xu, Xu, Xu, Xu, Uu^Uf, Uh, Urb, Uu^Uf, Urb, Uu, Uu^Vu, Ur, Uh, Uh, Uu^Uf, Uu^Uf, Ur, Ur, Ur, Xu, Xu, Uu, Co, Uh, Uu, Uh, Uh, Qxu, Qxu, Qxu, Xu, Xu, Xu, Xu, Uu^Uf, Uu^Uf, Ur, Ur, Uh, Uu^Uf, Xu, Xu, Xu, Xu, Xu, Xu
Xu, Xu, Xu, Xu, Uu^Uf, Uh, Ur, Uu^Uf, Xu, Xu, Xu, Uh, Uu^Uf, Ur, Uu, Co, Uu^Vu, Uh, Uh, Xu, Xu, Xu, Xu, Uu, Urb, Urb, Uh, Xu, Xu, Qxu, Xu, Xu, Xu, Xu, Xu, Xu, Xu, Xu, Xu, Uu^Uf, Xu, Xu, Xu, Xu, Xu, Xu, Xu
Xu, Xu, Xu, Uu^Uf, Uu^Uf, Ur, Uh, Uh, Xu, Xu, Xu, Uu^Uf, Uh, Uh, Xu, Uu, Uu^Uf, Uu^Uf, Xu, Xu, Xu, Xu, Xu, Xu, Uu^Uf, Uu, Xu, Xu, Xu, Xu, Xu, Xu, Xu, Xu, Xu, Xu, Xu, Xu, Xu, Xu, Xu, Xu, Xu, Xu, Xu, Xu, Xu
Xu, Xu, Uu, Uu, Uu, Ur, Xu, Xu, Xu, Xu, Xu, Xu, Xu, Xu, Xu, Xu, Xu, Xu, Xu, Xu, Xu, Xu, Xu, Xu, Uu^Uf, Rb, Xu, Xu, Xu, Xu, Xu, Xu, Xu, Xu, Xu, Xu, Xu, Xu, Xu, Xu, Xu, Xu, Xu, Xu, Xu, Xu, Xu
Uu^Uf, Uu^Uf, 1 Urb, Urb, Uh, Uu^Uf, Xu, Xu, Xu, Xu, Xu, Xu, Xu, Xu, Xu, Xu, Xu, Xu, Xu, Xu, Xu, Xu, Xu, Xu, Uh, Uh, Uu, Xu, Xu, Xu, Xu, Xu, Xu, Xu, Xu, Xu, Xu, Xu, Xu, Xu, Xu, Xu, Xu, Xu, Xu, Xu, Xu
Uu, Uu^Uf, Urb, Uh, Xu, Xu, Xu, Xu, Xu, Xu, Xu, Xu, Xu, Xu, Xu, Xu, Xu, Xu, Xu, Xu, Xu, Xu, Xu, Xu, Xu, Uu^Uf, Ur, Uh, Xu, Xu, Xu, Xu, Xu, Xu, Xu, Xu, Xu, Xu, Xu, Xu, Xu, Xu, Xu, Xu, Xu, Xu, Xu
Uu, Uu, Uu, Uh, Xu, Xu, Xu, Xu, Xu, Xu, Xu, Xu, Xu, Xu, Xu, Xu, Xu, Xu, Xu, Xu, Xu, Xu, Xu, Xu, Xu, Xu, Ur, Uh, Xu, Xu, Xu, Xu, Xu, Xu, Xu, Xu, Xu, Xu, Xu, Xu, Xu, Xu, Xu, Xu, Xu, Xu, Xu
