border_size=1
usage=map

Xu, Xu, Xu, Xu, Xu, Xu, Xu, Xu, Xu, Xu, Xu, Xu, Xu, Xu, Xu, Xu, Xu, Xos, Xos, Uu, Rrc, Uu, Xos, Xu, Xu, Xu, Xu, Xu, Xu, Xu, Xu, Xu, Xu, Xu, Xu, Xu, Xu, Xu, Xu, Xu, Xu
Xu, Xu, Xu, Xu, Xu, Xu, Xu, Xu, Xu, Xu, Xu, Xu, Xu, Xu, Xu, Xu, Xu, Xu, Xos, Uu, Rrc, Uh, Xos, Xu, Xu, Xu, Xu, Xu, Xu, Xu, Xu, Xu, Xu, Xu, Xu, Xu, Xu, Xu, Xu, Xu, Xu
Xu, Xu, Xu, Xu, Xu, Xu, Xu, Xu, Xu, Xu, Xu, Xu, Xu, Xu, Xu, Xu, Xu, Xu, Xol, Uu, Uu, Uh, Xol, Xu, Xu, Xu, Xu, Xu, Xu, Xu, Xu, Xu, Xu, Xu, Xu, Xu, Xu, Xu, Xu, Xu, Xu
Xu, Xu, Xu, Xu, Xu, Xu, Xu, Xu, Xu, Xu, Xu, Xu, Xu, Xu, Xu, Xu, Xos, Xol, Uh, Rrc, 1 Uu, Rrc, Rrc, Xos, Xu, Xu, Xu, Xu, Xu, Xu, Xu, Xu, Xu, Xu, Xu, Xu, Xu, Xu, Xu, Xu, Xu
Xu, Xu, Xu, Xu, Xu, Xu, Xu, Xu, Xu, Xu, Xu, Xu, Xu, Xu, Xu, Xu, Xos, Uh, Rrc, Rrc, Rrc, Rrc, Uh, Xos, Xu, Xu, Xu, Xu, Xu, Xu, Xu, Xu, Xu, Xu, Xu, Xu, Xu, Xu, Xu, Xu, Xu
Xu, Xu, Xu, Xu, Xu, Xu, Xu, Xu, Xu, Xu, Xu, Xu, Xu, Xu, Xu, Xu, Xos, Rrc, Uu, Uu, Uu, Uh, Rrc, Xos, Xu, Xu, Xu, Xu, Xu, Xu, Xu, Xu, Xu, Xu, Xu, Xu, Xu, Xu, Xu, Xu, Xu
Xu, Xu, Xu, Xu, Xu, Xu, Xu, Xu, Xu, Xu, Xu, Xu, Xu, Xu, Xu, Xu, Xol, Rrc, Rrc, Uu, Rrc, Uu, Rrc, Xos, Xu, Xu, Xu, Xu, Xu, Xu, Xu, Xu, Xu, Xu, Xu, Xu, Xu, Xu, Xu, Xu, Xu
Xu, Xu, Xu, Xu, Xu, Xu, Xu, Xu, Xu, Xu, Qxu, Qxu, Qxu, Xu, Qxu, Xol, Cud, Uh, Cud, Rrc, Cud, Rrc, Cud, Xos, Xu, Xu, Xu, Xu, Xu, Xu, Xu, Xu, Xu, Xu, Xu, Xu, Xu, Xu, Xu, Xu, Xu
Xu, Xu, Xu, Xu, Xu, Xu, Xu, Xu, Xu, Qxu, Qxu, Qxu, Qxu, Qxu, Qxu, Qxu, Cud, Cud, Cud, Cud, Cud, Cud, Cud, Xos, Xu, Xu, Xu, Xu, Xu, Xu, Xu, Xu, Xu, Xu, Xu, Xu, Xu, Xu, Xu, Xu, Xu
Xu, Xu, Xu, Xu, Xu, Xu, Xu, Xu, Xu, Qxu, Qxu, Qxu, Qxu, Qxu, Uu^Uf, Qxu, Ur, Uu, Rrc, Uu, Urb, Urb, Urb, Xol, Xol, Xu, Xu, Xu, Xu, Xu, Xos, Xu, Xu, Xu, Xu, Xu, Xu, Xu, Xu, Xu, Xu
Xu, Xu, Xu, Xu, Xu, Xu, Xu, Xu, Xu, Xos, Uh, Qxu, Qxu, Uu^Uf, Uh, Uh, Uu^Vud, Ur, Uu, Rrc, Uu^Vud, Uu^Vud, Uu, Ur, Uu^Vud, Xol, Xol, Xu, Xol, Xol, Cud, Xol, Xol, Xu, Xol, Xos, Xol, Xu, Xos, Xu, Xos
Xu, Xu, Xu, Xu, Xu, Xu, Xu, Xu, Xol, Xol, Uu^Vud, Uh, Qxu, Qxu, Uu, Uu^Vud, Uu^Vud, Uu, Cud, Rrc, Rrc, Uu^Vud, Uu, Ur, Uu^Vud, Uu^Vud, Uu, Xos, Cud, Cud, Cud, Ur, Ur, Xol, Uu, Cud, Cud, Xol, Uh, Xos, Uu
Xu, Xu, Xol, Xos, Xos, Xu, Xol, Xol, Cud, Cud, Uu^Vud, Uu^Vud, Cud, Cud, Uu, Ur, Ur, Uu, Cud, Ur, Uu, Rrc, Rrc, Uu, Cud, Ur, Uu, Uu, Uu^Vud, Cud, Uu, Uu, Uu, Uh, Uu, Cud, Cud, Ur, Uh, Uu^Uf, Uu
Xol, Xol, Rrc, Rrc, Rrc, Xol, Uh, Cud, Cud, Cud, Uu, Uu, Rrc, Rrc, Rrc, Uu, Rrc, Uh, Uh, Cud, Uu, Uu, Rrc, Uh, Uu^Vud, Cud, Ur, Uu^Vud, Uu^Vud, Ur, Ur, Uu^Vud, Uu^Vud, Uh, Urb, Xos, Xol, Ur, Uu, Uh, Uu
Uu, Rrc, Cud, Cud, Cud, Rrc, Ur, Ur, Uh, Uu, Rrc, Rrc, Uu^Vud, Uu^Vud, Uu, Rrc, Uu, Rrc, Rrc, Uu, Uh, Uh, Rrc, Uu^Vud, Uu^Vud, Cud, Uu, Ur, Uu, Uu, Uu, Uu^Vud, Uu, Uu, Rrc, Xol, Cud, Uu, Uu, Uu^Uf, Uu
Uu, Uu, Cud, Kud, Cud, Rrc, Uu, Rrc, Rrc, Rrc, Uu^Vud, Uh, Cud, Cud, Uu^Vud, Uu, Ur, Ur, Uu^Vud, Rrc, Rrc, Rrc, Cud, Rrc, Rrc, Ur, Uh, Uu, Cud, Ur, Rrc, Rrc, Rrc, Rrc, Uu, Cud, Cud, Uh, Ur, Uu^Uf, Uu
Rrc, Uu, Rrc, Cud, Rrc, Rrc, Xos, Uu^Uf, Uu, Uu^Vud, Uu, Uh, Cud, Cud, Uu^Vud, Uu^Vud, Ur, Ur, Uu^Vud, Uu^Vud, Rrc, Cud, 2 Kud, Cud, Rrc, Uh, Uu^Vud, Uu, Cud, Rrc, Uh, Uu^Vud, Uu^Vud, Uu, Uu, Xos, Xol, Ur, Uh, Uu, Uu
Xos, Xos, Xos, Rrc, Xos, Xos, Xos, Xos, Xos, Uu, Xos, Xos, Xos, Xos, Xos, Uh, Uh, Cud, Urb, Urb, Rrc, Cud, Cud, Cud, Rrc, Urb, Uu^Vud, Cud, Rrc, Rrc, Uh, Uu^Vud, Ur, Ur, Uh, Xol, Cud, Uh, Uu^Uf, Uh, Xos
Xu, Xu, Xu, Xos, Xu, Xos, Xu, Xu, Xu, Xos, Xos, Xu, Xu, Xos, Xos, Uu^Uf, Uu^Vud, Cud, Cud, Uh, Uh, Rrc, Rrc, Rrc, Uu^Vud, Rrc, Rrc, Rrc, Uh, Uu, Uu, Uu, Xos, Uh, Uh, Cud, Cud, Uu, Xos, Xos, Xu
Xu, Xu, Xu, Xu, Xu, Xu, Xu, Xu, Xu, Xu, Xu, Xu, Xu, Xu, Xos, Uu^Vud, Uu^Vud, Uu, Uu, Uu, Ur, Urb, Uu, Uu^Vud, Cud, Uu, Uu, Uh, Uu, Ur, Xos, Xos, Xos, Xos, Xos, Cud, Xos, Xos, Xu, Xu, Xu
Xu, Xu, Xu, Xu, Xu, Xu, Xu, Xu, Xu, Xu, Xu, Xu, Xu, Xu, Xu, Xos, Xos, Urb, Uh, Uh, Uu^Vud, Ur, Uu, Cud, Urb, Uu, Ur, Urb, Xos, Xos, Xu, Xu, Xu, Xu, Xu, Xos, Xu, Xu, Xu, Xu, Xu
Xu, Xu, Xu, Xu, Xu, Xu, Xu, Xu, Xu, Xu, Xu, Xu, Xu, Xu, Xu, Xu, Xu, Xos, Xos, Uu^Vud, Uu^Vud, Ur, Uh, Uu, Uu^Vud, Ur, Cud, Cud, Xos, Xu, Xu, Xu, Xu, Xu, Xu, Xu, Xu, Xu, Xu, Xu, Xu
Xu, Xu, Xu, Xu, Xu, Xu, Xu, Xu, Xu, Xu, Xu, Xu, Xu, Xu, Xu, Xu, Xu, Xu, Xu, Xos, Cud, Cud, Cud, Uh, Uu^Vud, Uu^Vud, Cud, Cud, Xos, Xu, Xu, Xu, Xu, Xu, Xu, Xu, Xu, Xu, Xu, Xu, Xu
Xu, Xu, Xu, Xu, Xu, Xu, Xu, Xu, Xu, Xu, Xu, Xu, Xu, Xu, Xu, Xu, Xu, Xu, Xu, Xos, Xos, Cud, Rrc, Uh, Ur, Uu, Uu, Xos, Xu, Xu, Xu, Xu, Xu, Xu, Xu, Xu, Xu, Xu, Xu, Xu, Xu
Xu, Xu, Xu, Xu, Xu, Xu, Xu, Xu, Xu, Xu, Xu, Xu, Xu, Xu, Xu, Xu, Xu, Xu, Xu, Xu, Xu, Xos, Rrc, Uu, Uh, Ur, Uu^Uf, Xos, Xu, Xu, Xu, Xu, Xu, Xu, Xu, Xu, Xu, Xu, Xu, Xu, Xu
Xu, Xu, Xu, Xu, Xu, Xu, Xu, Xu, Xu, Xu, Xu, Xu, Xu, Xu, Xu, Xu, Xu, Xu, Xu, Xu, Xu, Xos, Xos, Rrc, Uh, Uu^Uf, Rrc, Xos, Xu, Xu, Xu, Xu, Xu, Xu, Xu, Xu, Xu, Xu, Xu, Xu, Xu
Xu, Xu, Xu, Xu, Xu, Xu, Xu, Xu, Xu, Xu, Xu, Xu, Xu, Xu, Xu, Xu, Xu, Xu, Xu, Xu, Xu, Xu, Xos, Uu, Ur, Uu, Rrc, Xos, Xu, Xu, Xu, Xu, Xu, Xu, Xu, Xu, Xu, Xu, Xu, Xu, Xu
Xu, Xu, Xu, Xu, Xu, Xu, Xu, Xu, Xu, Xu, Xu, Xu, Xu, Xu, Xu, Xu, Xu, Xu, Xu, Xu, Xu, Xu, Xu, Ur, Uu, Rrc, Uh, Uh, Uu, Xu, Xu, Xu, Xu, Xu, Xu, Xu, Xu, Xu, Xu, Xu, Xu
Xu, Xu, Xu, Xu, Xu, Xu, Xu, Xu, Xu, Xu, Xu, Xu, Xu, Xu, Xu, Xu, Xu, Xu, Xu, Xu, Xu, Xu, Xu, Xu, Xu, Uu, Rrc, Uu^Uf, Rrc, Uu, Xu, Xu, Xu, Xu, Xu, Xu, Xu, Xu, Xu, Xu, Xu
Xu, Xu, Xu, Xu, Xu, Xu, Xu, Xu, Xu, Xu, Xu, Xu, Xu, Xu, Xu, Xu, Xu, Xu, Xu, Xu, Xu, Xu, Xu, Xu, Xu, Xu, Xu, Rrc, Uu, Uh, Uh, Xu, Xu, Xu, Xu, Xu, Xu, Xu, Xu, Xu, Xu
Xu, Xu, Xu, Xu, Xu, Xu, Xu, Xu, Xu, Xu, Xu, Xu, Xu, Xu, Xu, Xu, Xu, Xu, Xu, Xu, Xu, Xu, Xu, Xu, Xu, Xu, Xu, Rrc, Uu, Uu^Uf, Rrc, Xu, Xu, Xu, Xu, Xu, Xu, Xu, Xu, Xu, Xu
Xu, Xu, Xu, Xu, Xu, Xu, Xu, Xu, Xu, Xu, Xu, Xu, Xu, Xu, Xu, Xu, Xu, Xu, Xu, Xu, Xu, Xu, Xu, Xu, Xu, Xu, Xu, Uu^Uf, Rrc, Rrc, Uu^Uf, Xu, Xu, Xu, Xu, Xu, Xu, Xu, Xu, Xu, Xu
