Xu, Xu, Xu, Xu, Xu, Xu, Xu, Xu, Xu, Xu, Xu, Xu, Xu, Xu, Xu, Xu, Xu, Xos, Xos, Uu, Rrc, Uu, Xos, Xu, Xu, Xu, Xu, Xu, Xu, Xu, Xu, Xu, Xu, Xu, Xu, Xu, Xu, Xu, Xu, Xu, Xu
Xu, Xu, Xu, Xu, Xu, Xu, Xu, Xu, Xu, Xu, Xu, Xu, Xu, Xu, Xu, Xu, Xu, Xu, Xos, Uu, Rrc, Uh, Xos, Xu, Xu, Xu, Xu, Xu, Xu, Xu, Xu, Xu, Xu, Xu, Xu, Xu, Xu, Xu, Xu, Xu, Xu
Xu, Xu, Xu, Xu, Xu, Xu, Xu, Xu, Xu, Xu, Xu, Xu, Xu, Xu, Xu, Xu, Xu, Xu, Xos, Uu, Uu, Uh, Xos, Xu, Xu, Xu, Xu, Xu, Xu, Xu, Xu, Xu, Xu, Xu, Xu, Xu, Xu, Xu, Xu, Xu, Xu
Xu, Xu, Xu, Xu, Xu, Xu, Xu, Xu, Xu, Xu, Xu, Xu, Xu, Xu, Xu, Xu, Xos, Xos, Uh, Irs, 1 Uu, Irs, Irs, Xos, Xu, Xu, Xu, Xu, Xu, Xu, Xu, Xu, Xu, Xu, Xu, Xu, Xu, Xu, Xu, Xu, Xu
Xu, Xu, Xu, Xu, Xu, Xu, Xu, Xu, Xu, Xu, Xu, Xu, Xu, Xu, Xu, Xu, Xos, Uh, Irs, Irs, Irs, Irs, Uh, Xos, Xu, Xu, Xu, Xu, Xu, Xu, Xu, Xu, Xu, Xu, Xu, Xu, Xu, Xu, Xu, Xu, Xu
Xu, Xu, Xu, Xu, Xu, Xu, Xu, Xu, Xu, Xu, Xu, Xu, Xu, Xu, Xu, Xu, Xos, Irs, Uu, Uu, Uu, Uh, Irs, Xos, Xu, Xu, Xu, Xu, Xu, Xu, Xu, Xu, Xu, Xu, Xu, Xu, Xu, Xu, Xu, Xu, Xu
Xu, Xu, Xu, Xu, Xu, Xu, Xu, Xu, Xu, Xu, Xu, Xu, Xu, Xu, Xu, Xu, Xos, Irs, Irs, Uu, Irs, Uu, Irs, Xos, Xu, Xu, Xu, Xu, Xu, Xu, Xu, Xu, Xu, Xu, Xu, Xu, Xu, Xu, Xu, Xu, Xu
Xu, Xu, Xu, Xu, Xu, Xu, Xu, Xu, Xu, Xu, Qxu, Qxu, Qxu, Xu, Qxu, Xos, Cud, Uh, Cud, Irs, Cud, Irs, Cud, Xos, Xu, Xu, Xu, Xu, Xu, Xu, Xu, Xu, Xu, Xu, Xu, Xu, Xu, Xu, Xu, Xu, Xu
Xu, Xu, Xu, Xu, Xu, Xu, Xu, Xu, Xu, Qxu, Qxu, Qxu, Qxu, Qxu, Qxu, Qxu, Cud, Cud, Cud, Cud, Cud, Cud, Cud, Xos, Xu, Xu, Xu, Xu, Xu, Xu, Xu, Xu, Xu, Xu, Xu, Xu, Xu, Xu, Xu, Xu, Xu
Xu, Xu, Xu, Xu, Xu, Xu, Xu, Xu, Xu, Qxu, Qxu, Qxu, Qxu, Qxu, Tb^Tf, Qxu, Ur, Uu, Irs, Uu, Urb, Urb, Urb, Xos, Xos, Xu, Xu, Xu, Xu, Xu, Xos, Xu, Xu, Xu, Xu, Xu, Xu, Xu, Xu, Xu, Xu
Xu, Xu, Xu, Xu, Xu, Xu, Xu, Xu, Xu, Xos, Uh, Qxu, Qxu, Tb^Tf, Uh, Uh, Uu^Vud, Ur, Uu, Irs, Uu^Vud, Uu^Vud, Uu, Ur, Uu^Vud, Xos, Xos, Xu, Xos, Xos, Cud, Xos, Xos, Xu, Xos, Xos, Xos, Xu, Xos, Xu, Xos
Xu, Xu, Xu, Xu, Xu, Xu, Xu, Xu, Xos, Xos, Uu^Vud, Uh, Qxu, Qxu, Uu, Uu^Vud, Uu^Vud, Uu, Cud, Irs, Irs, Uu^Vud, Uu, Ur, Uu^Vud, Uu^Vud, Uu, Xos, Cud, Cud, Cud, Ur, Ur, Xos, Uu, Cud, Cud, Xos, Uh, Xos, Uu
Xu, Xu, Xos, Xos, Xos, Xu, Xos, Xos, Cud, Cud, Uu^Vud, Uu^Vud, Cud, Cud, Uu, Ur, Ur, Uu, Cud, Ur, Uu, Irs, Irs, Uu, Cud, Ur, Uu, Uu, Uu^Vud, Cud, Uu, Uu, Uu, Uh, Uu, Cud, Cud, Ur, Uh, Tb^Tf, Uu
Xos, Xos, Irs, Irs, Irs, Xos, Uh, Cud, Cud, Cud, Uu, Uu, Irs, Irs, Irs, Uu, Irs, Uh, Uh, Cud, Uu, Uu, Rrc, Uh, Uu^Vud, Cud, Ur, Uu^Vud, Uu^Vud, Ur, Ur, Uu^Vud, Uu^Vud, Uh, Urb, Xos, Xos, Ur, Uu, Uh, Uu
Uu, Irs, Cud, Cud, Cud, Irs, Irs, Ur, Uh, Uu, Irs, Irs, Uu^Vud, Uu^Vud, Uu, Irs, Uu, Irs, Irs, Uu, Uh, Uh, Irs, Uu^Vud, Uu^Vud, Cud, Uu, Ur, Uu, Uu, Uu, Uu^Vud, Uu, Uu, Irs, Xos, Cud, Uu, Uu, Tb^Tf, Uu
Uu, Uu, Cud, Kud, Cud, Irs, Uu, Irs, Irs, Irs, Uu^Vud, Uh, Cud, Cud, Uu^Vud, Uu, Ur, Ur, Uu^Vud, Irs, Irs, Rrc, Cud, Irs, Irs, Ur, Uh, Uu, Cud, Ur, Irs, Irs, Irs, Irs, Uu, Cud, Cud, Uh, Ur, Tb^Tf, Uu
Rrc, Uu, Irs, Cud, Irs, Irs, Xos, Tb^Tf, Uu, Uu^Vud, Uu, Uh, Cud, Cud, Uu^Vud, Uu^Vud, Ur, Ur, Uu^Vud, Uu^Vud, Irs, Cud, 2 Kud, Cud, Irs, Uh, Uu^Vud, Uu, Cud, Irs, Uh, Uu^Vud, Uu^Vud, Uu, Uu, Xos, Xos, Ur, Uh, Uu, Uu
Xos, Xos, Xos, Irs, Xos, Xos, Xos, Xos, Xos, Uu, Xos, Xos, Xos, Xos, Xos, Uh, Uh, Cud, Urb, Urb, Irs, Cud, Cud, Cud, Irs, Urb, Uu^Vud, Cud, Irs, Irs, Uh, Uu^Vud, Ur, Ur, Uh, Xos, Cud, Uh, Tb^Tf, Uh, Xos
Xu, Xu, Xu, Xos, Xu, Xos, Xu, Xu, Xu, Xos, Xos, Xu, Xu, Xos, Xos, Tb^Tf, Uu^Vud, Cud, Cud, Uh, Uh, Irs, Irs, Irs, Uu^Vud, Irs, Irs, Irs, Uh, Uu, Uu, Uu, Xos, Uh, Uh, Cud, Cud, Uu, Xos, Xos, Xu
Xu, Xu, Xu, Xu, Xu, Xu, Xu, Xu, Xu, Xu, Xu, Xu, Xu, Xu, Xos, Uu^Vud, Uu^Vud, Uu, Uu, Uu, Irs, Irs, Uu, Uu^Vud, Cud, Uu, Uu, Uh, Uu, Ur, Xos, Xos, Xos, Xos, Xos, Cud, Xos, Xos, Xu, Xu, Xu
Xu, Xu, Xu, Xu, Xu, Xu, Xu, Xu, Xu, Xu, Xu, Xu, Xu, Xu, Xu, Xos, Xos, Urb, Uh, Uh, Uu^Vud, Irs, Uu, Cud, Urb, Uu, Ur, Urb, Xos, Xos, Xu, Xu, Xu, Xu, Xu, Xos, Xu, Xu, Xu, Xu, Xu
Xu, Xu, Xu, Xu, Xu, Xu, Xu, Xu, Xu, Xu, Xu, Xu, Xu, Xu, Xu, Xu, Xu, Xos, Xos, Uu^Vud, Uu^Vud, Irs, Irs, Uu, Uu^Vud, Ur, Cud, Cud, Xos, Xu, Xu, Xu, Xu, Xu, Xu, Xu, Xu, Xu, Xu, Xu, Xu
Xu, Xu, Xu, Xu, Xu, Xu, Xu, Xu, Xu, Xu, Xu, Xu, Xu, Xu, Xu, Xu, Xu, Xu, Xu, Xos, Cud, Cud, Cud, Irs, Uu^Vud, Uu^Vud, Cud, Cud, Xos, Xu, Xu, Xu, Xu, Xu, Xu, Xu, Xu, Xu, Xu, Xu, Xu
Xu, Xu, Xu, Xu, Xu, Xu, Xu, Xu, Xu, Xu, Xu, Xu, Xu, Xu, Xu, Xu, Xu, Xu, Xu, Xos, Xos, Cud, Rrc, Uh, Ur, Uu, Uu, Xos, Xu, Xu, Xu, Xu, Xu, Xu, Xu, Xu, Xu, Xu, Xu, Xu, Xu
Xu, Xu, Xu, Xu, Xu, Xu, Xu, Xu, Xu, Xu, Xu, Xu, Xu, Xu, Xu, Xu, Xu, Xu, Xu, Xu, Xu, Xos, Rrc, Uu, Uh, Ur, Tb^Tf, Xos, Xu, Xu, Xu, Xu, Xu, Xu, Xu, Xu, Xu, Xu, Xu, Xu, Xu
Xu, Xu, Xu, Xu, Xu, Xu, Xu, Xu, Xu, Xu, Xu, Xu, Xu, Xu, Xu, Xu, Xu, Xu, Xu, Xu, Xu, Xos, Xos, Rrc, Uh, Tb^Tf, Rrc, Xos, Xu, Xu, Xu, Xu, Xu, Xu, Xu, Xu, Xu, Xu, Xu, Xu, Xu
Xu, Xu, Xu, Xu, Xu, Xu, Xu, Xu, Xu, Xu, Xu, Xu, Xu, Xu, Xu, Xu, Xu, Xu, Xu, Xu, Xu, Xu, Xos, Uu, Ur, Uu, Rrc, Xos, Xu, Xu, Xu, Xu, Xu, Xu, Xu, Xu, Xu, Xu, Xu, Xu, Xu
Xu, Xu, Xu, Xu, Xu, Xu, Xu, Xu, Xu, Xu, Xu, Xu, Xu, Xu, Xu, Xu, Xu, Xu, Xu, Xu, Xu, Xu, Xu, Ur, Uu, Rrc, Uh, Uh, Uu, Xu, Xu, Xu, Xu, Xu, Xu, Xu, Xu, Xu, Xu, Xu, Xu
Xu, Xu, Xu, Xu, Xu, Xu, Xu, Xu, Xu, Xu, Xu, Xu, Xu, Xu, Xu, Xu, Xu, Xu, Xu, Xu, Xu, Xu, Xu, Xu, Xu, Uu, Rrc, Tb^Tf, Rrc, Uu, Xu, Xu, Xu, Xu, Xu, Xu, Xu, Xu, Xu, Xu, Xu
Xu, Xu, Xu, Xu, Xu, Xu, Xu, Xu, Xu, Xu, Xu, Xu, Xu, Xu, Xu, Xu, Xu, Xu, Xu, Xu, Xu, Xu, Xu, Xu, Xu, Xu, Xu, Rrc, Uu, Uh, Uh, Xu, Xu, Xu, Xu, Xu, Xu, Xu, Xu, Xu, Xu
Xu, Xu, Xu, Xu, Xu, Xu, Xu, Xu, Xu, Xu, Xu, Xu, Xu, Xu, Xu, Xu, Xu, Xu, Xu, Xu, Xu, Xu, Xu, Xu, Xu, Xu, Xu, Rrc, Uu, Tb^Tf, Rrc, Xu, Xu, Xu, Xu, Xu, Xu, Xu, Xu, Xu, Xu
Xu, Xu, Xu, Xu, Xu, Xu, Xu, Xu, Xu, Xu, Xu, Xu, Xu, Xu, Xu, Xu, Xu, Xu, Xu, Xu, Xu, Xu, Xu, Xu, Xu, Xu, Xu, Tb^Tf, Rrc, Rrc, Tb^Tf, Xu, Xu, Xu, Xu, Xu, Xu, Xu, Xu, Xu, Xu
