Dd, Dd, Dd, Dd, Dd^Ftd, Dd, Dd, Dd^Esd, Dd^Dc, Dd, Dd^Ftd, Dd, Dd, Dd^Edpp, Dd, Dd, Dd^Edp, Dd^Esd, Dd, Dd, Dd, Dd, Dd
Dd, Dd^Ftd, Dd, Dd^Edpp, Dd, Dd, Dd^Ftd, Dd, Dd, Dd, Dd, Dd, Dd, Dd^Esd, Dd, Dd, Dd^Edp, Dd^Edp, Dd^Esd, Dd, Dd, Dd^Esd, Dd
Dd, Dd, Dd, Dd^Ftd, Dd, Dd, Dd, Dd, Dd, Dd^Edp, Dd^Edp, Dd, Dd^Ftd, Dd^Edpp, Dd, Dd, Dd, Dd, Dd, Dd^Ftd, Dd, Dd, Dd
Dd^Edp, Dd, Dd^Dc, Dd^Esd, Dd^Edp, Dd, Dd, Dd, Dd, Dd, Dd^Edp, Dd^Edp, Gs, Gs, Dd^Ftd, Dd, Dd, Dd, Dd, Dd, Dd, Dd^Edpp, Dd
Dd, Dd, Dd, Dd, Dd, Dd, Dd^Edpp, Dd, Gs, Dd^Edpp, Dd, Dd, Gs^Ftp, Gs^Ftp, Gs, Dd^Edpp, Gs, Dd, Dd, Dd, Dd, Dd^Edpp, Dd
Dd, Dd, Dd, Dd^Edp, Dd, Dd^Edp, Dd, Gs, Gs, Gs, Gs^Ftp, Gs, Gs, Gs^Ftp, Gs, Gs, Gs, Gs, Dd, Dd, Dd, Dd, Dd
Dd, Dd^Edp, Dd, Dd^Edp, Dd^Edpp, Dd, Gs^Ftp, Gs, Gs, Gs^Ftp, Gs^Ftp, Gs^Ftp, Gs, Gs, Gs^Ftp, Gs, Gs, Gs, Gs, Dd, Dd^Esd, Dd^Esd, Dd
Dd^Edpp, Dd^Ftd, Dd, Dd, Dd, Gs, Gs^Ftp, Gs^Ftp, Gs, Gs, Gs, Gs^Ftp, Gs, Gs, Gs^Ftp, Gs^Ftp, Gs, Gs^Ftp, Gs^Ftp, Dd, Dd, Dd, Dd
Dd, Dd, Dd, Dd, Dd, Gs, Gs^Ftp, Gs, Ds, Ds, Ds, Gs, Ds, Gs, Gs, Gs^Ftp, Gs, Gs^Ftp, Gs^Ftp, Dd^Esd, Dd, Dd^Edpp, Dd^Edp
Dd^Edp, Dd^Esd, Dd^Edp, Dd, Gs, Gs^Ftp, Gs, Gs, Wwg, Wwg, Wwg, Wwg, Wwg, Ds, Gs, Gs, Gs^Ftp, Gs, Gs, Dd, Dd^Esd, Dd, Dd
Dd, Dd^Ftd, Dd, Gs, Gs, Gs, Gs, Ds, Wwg, Wwg, Wwg, Wwg, Wwg, Wwg, Ds, Gs, Gs^Ftp, Gs^Ftp, Gs, Dd^Edpp, Dd^Edp, Dd, Dd
Dd, Dd, Dd^Edpp, Gs, Gs^Ftp, Gs^Ftp, Gs, Ds, Ds, Wwg, Wwg, Wwg, Wwg, Wwg, Wwg, Ds, Gs, Gs^Ftp, Dd, Dd, Dd, Dd, Dd^Dc
Dd, Dd, Dd, Dd, Gs^Ftp, Gs^Ftp, Gs^Ftp, Gs, 1 Gs, Wwg, Wwg, Wwg, Wwg, Wwg, Wwg, Ds, Gs, Gs^Ftp, Gs, Dd, Dd^Ftd, Dd^Edp, Dd
Dd^Edp, Dd, Dd^Edp, Dd, Gs, Gs, Gs, Gs, Gs, Ds, Ds, Wwg, Ds, Wwg, Ds, Gs, Gs, Gs, Dd, Dd, Dd, Dd, Dd
Dd, Dd, Dd^Ftd, Dd, Dd, Gs, Gs^Ftp, Gs^Ftp, Gs, Gs, Gs, Gs, Gs, Ds, Gs, Gs, Gs^Ftp, Gs, Dd^Edp, Dd, Dd, Dd, Dd^Edpp
Dd, Dd^Edp, Dd^Esd, Dd^Ftd, Dd, Dd^Esd, Gs^Ftp, Gs^Ftp, Gs^Ftp, Gs, Gs^Ftp, Gs^Ftp, Gs^Ftp, Gs, Gs, Gs^Ftp, Gs^Ftp, Dd, Dd, Dd, Dd, Dd, Dd^Esd
Dd, Dd, Dd, Dd, Dd, Gs, Gs, Gs^Ftp, Gs, Gs, Gs, Gs^Ftp, Gs, Gs, Dd^Ftd, Dd, Dd, Dd, Dd, Dd, Dd^Edp, Dd, Dd^Esd
Dd, Dd, Dd^Esd, Dd, Dd^Edpp, Dd, Dd^Edp, Dd, Gs^Ftp, Gs^Ftp, Dd, Gs, Dd, Dd, Dd, Dd^Ftd, Dd, Dd, Dd, Dd^Ftd, Dd, Dd, Dd
Dd^Ftd, Dd, Dd, Dd, Dd^Esd, Dd, Dd, Dd^Edpp, Dd^Ftd, Gs^Ftp, Dd, Dd^Edp, Dd, Dd, Dd^Edpp, Dd, Dd^Ftd, Dd, Dd^Edpp, Dd, Dd, Dd, Dd
Dd^Edpp, Dd^Edpp, Dd, Dd, Dd^Edp, Dd, Dd, Dd^Edpp, Dd, Dd^Esd, Dd^Dc, Dd^Esd, Dd^Edpp, Dd, Dd, Dd^Edp, Dd^Dc, Dd, Dd^Edpp, Dd, Dd, Dd, Dd
Dd^Edp, Dd, Dd^Edp, Dd, Dd^Ftd, Dd^Edp, Dd, Dd, Dd^Edp, Dd, Dd^Ftd, Dd^Edpp, Dd, Dd^Dc, Dd, Dd^Ftd, Dd, Dd, Dd^Edpp, Dd, Dd, Dd, Dd
Dd, Dd^Esd, Dd^Edp, Dd, Dd, Dd, Dd, Dd, Dd, Dd, Dd, Dd, Dd, Dd, Dd, Dd, Dd, Dd^Dc, Dd, Dd, Dd, Dd^Ftd, Dd^Edp
Dd, Dd, Dd, Dd, Dd^Esd, Dd, Dd, Dd^Edp, Dd, Dd, Dd^Edp, Dd^Esd, Dd^Esd, Dd^Edpp, Dd, Dd, Dd, Dd^Esd, Dd, Dd^Esd, Dd, Dd, Dd
