Gg, Gg, Gg, Gg, Rp, Gg, Gg, Gg, Ww^Bsb\, Ww, Ch, Ww, Ww, Wo, Ww, Ww, Rrc, Gg, Gg^Vhc, Gg, Rrc, Gg, Rrc, Ww^Bsb/, Ww, Gg, Ww, Gg, Gg, Gg, Ce, Gg, Gg
Gg, Gg, Gs^Vh, Gg, Rp, Ww, Wo, Ww, Ch, Rrc, Rrc, Gg, Gg^Vhc, Ww, Wo, Ww, Ww, Rrc, Rrc, Rrc, Gg^Vhc, Gg, Ch, Ch, Ch, Ww, Ww, Rp, Rp, Gg, Re, Gg, Gg
Gg, Gs^Vh, Gg, Gg, Rp, Ww^Bsb\, Ww^Bsb\, Ww, Rrc, Rrc, Gg^Vhc, Rrc, Rrc, Ww, Ww, Wo, Wo, Ww^Bsb|, Ww, Ww, Ww, Ww, Ww, Kh, Ch, Ww, Wo, Ww, Re, Ce, Re, Gg, Gg
Gg, Gg, Gg, Gg, Rp, Ww, Ww, Rrc, Ch, Ch, Ch, Gg, Ww^Bsb|, Ww, Ww, Ww, Ww, Wo^Bsb|, Wo, Wo, Ww, Ww, Ww, Ww, Ww, Ww, Ww, Ww, Re, Ce, Gg, Gg, Gg^Eff
Gg, Gg, Gs^Vh, Gs^Vh, Rp, Ww, Ww^Bsb/, Rrc, Ch, Kh, Ww, Ww, Ww^Bsb|, Ww, Rrc, Ch, Ch, Ww^Bsb|, Ww, Ww, Rrc, Ch, Ch, Ww, Ww, Wo, Ww, Gg, Rp, Re, Re, Gg^Eff, Gg^Eff
Gg^Eff, Gs^Vh, Gs^Vh, Gs^Vh, Rp, Ww^Bsb/, Ww, Ww, Ww, Ww, Ww, Ww, Rrc, Ch, Gg, Gg, Gg, Rrc, Ch, Ch, Gg, Gs^Fds, Gs^Fds, Rrc, Ch, Ww, Ww, Gg, Rp, Ce, Ce, Gg, Gg
Gg^Gvs, Gg^Eff, Gg^Eff, Gg, Cud, Rp, Rp, Ww, Ww, Wo, Ww, Ch, Rrc, Gg, Gg^Vhc, Gs^Fds, Gg, Rrc, Rrc, Gg, Gg^Vhc, Gg, Gg, Gg, Ch, Ww, Ww, Gg, Rp, Re, Ce, Gg, Gg
Gg^Gvs, Gg^Gvs, Gg^Gvs, Gg^Eff, Gg^Eff, Gg, Gg, Rp, Rp, Ww, Ww, Rrc, Gg^Vhc, Rrc, Rrc, Gs^Fds, Gs^Fds, Gg, Gg^Vhc, Rrc, Gg, Gs^Fds, Gg^Vhc, Gg, Rrc, Ww, Ww, Ww, Rp, Re, Re, Gg, Gg
Gg^Gvs, Gg^Gvs, Gg^Gvs, Gg^Gvs, Gg^Gvs, Gg^Eff, Gg^Eff, Gg, Rp, Ww, Ww, Ch, Ch, Gg, Gg, Rrc, Rrc, Gg, Gg, Rrc, Gg, Gs^Fds, Gs^Fds, Gg, Gg, Ch, Ww, Ww, Rp, Gg^Vc, Re, Gg, Gg
Gg^Gvs, Gg^Gvs, Gg^Gvs, Gg^Gvs, Gg^Eff, Gg^Eff, Cud, Rp, Ww, Ww, Wo, Ww, Rrc, Gg, Gg^Vhc, Gg, Rrc, Gg^Vhc, Rrc, Rrc, Rrc, Gg, Gg, Gg, Gs^Fds, Ch, Ww, Ww, Ww, Rp, Ce, Re, Gg
Gg^Gvs, Gg^Gvs, Gg^Eff, Gg^Eff, Gs^Vh, Gg, Gg, Rp, Ww^Bsb\, Wo, Ww, Ww, Rrc, Gg, Gs^Fds, Gs^Fds, Gg, Rrc, Ch, Ch, Ch, Rrc, Gg^Vhc, Gg, Gs^Fds, Rrc, Ch, Ww, Ww^Bsb/, Rp, Ce, Re, Gg
Gg^Eff, Gg^Eff, Gg, Gs^Vh, Gs^Vh, Gs^Vh, Rp, Rp, Ww, Wo^Bsb\, Ww^Bsb\, Ch, Gg^Vhc, Gg, Gs^Fds, Gg^Vhc, Rrc, Rrc, Ch, 1 Kh, Ch, Rrc, Rrc, Gs^Fds, Rrc, Rrc, Rrc, Ww^Bsb/, Ww, Rp, Gg, Re, Gg
Gg^Gvs, Gg^Eff, Gg^Eff, Gg, Rp, Rp, Ww, Ww, Wo, Wo, Ww, Rrc, Rrc, Gg, Rrc, Rrc, Gg, Rrc, Rrc, Ch, Rrc, Rrc, Gg, Rrc, Gg, Gg^Vhc, Ch, Ww, Ww, Rp, Re, Re, Gg
Gg^Eff, Gg^Eff, Cud, Rp, Ww^Bsb\, Ww, Ww, Wo, Wo, Ww, Rrc, Rrc, Gs^Fds, Rrc, Gg, Gg^Vhc, Gg, Gg, Rrc, Rrc, Gg^Vhc, Gg, Gg, Gg, Gs^Fds, Gg, Ch, Ww, Ww, Rp, Ce, Gg, Gg
Gg, Gg, Rp, Rp, Ww, Ww^Bsb\, Rrc, Ww, Ww, Ww, Rrc, Gg, Gg, Rrc, Gg, Gg, Gs^Fds, Gg^Vhc, Rrc, Gg, Gs^Fds, Gs^Fds, Gg, Gg^Vhc, Gs^Fds, Gg, Rrc, Ww, Ww, Rp, Ce, Re, Gg
Gs^Vh, Gs^Vh, Rp, Ww, Ww, Ww, Ch, Rrc, Ww, Ww, Ch, Gg^Vhc, Rrc, Rrc, Rrc, Gg^Vhc, Gs^Fds, Gs^Fds, Rrc, Gg, Gg, Gs^Fds, Gg, Gs^Fds, Gg^Vhc, Gg, Ch, Ww, Ww, Re, Re, Re, Re
Rp, Rp, Ww, Ww, Ww, Ch, Gg, Rrc, Ww, Ww, Ww^Bsb/, Rrc, Gg, Gg, Gg^Vhc, Rrc, Rrc, Rrc, Gg^Vhc, Rrc, Rrc, Gg, Ch, Gg, Rrc, Ch, Ww, Ww, Wo, Ww, Ww, Rp, Rp
Rp, Ww, Wo, Ww, Ch, Gg, Gg^Vhc, Rrc, Ww^Bsb/, Wo^Bsb/, Ww, Ch, Ch, Gs^Fds, Gs^Fds, Gs^Fds, Rrc, Gg, Gg, Gg, Ch, Rrc, Ww^Bsb\, Ch, Ww, Ww, Ww, Ww, Ww, Wo, Ww^Bsb/, Re, Rp
Rp, Ww, Wo, Ww, Ch, Gg^Vhc, Rrc, Rrc, Ww, Wo, Wo, Ww, Ww^Bsb/, Rrc, Ch, Ch, Ww^Bsb|, Ch, Ch, Rrc, Ww, Ww, Wo, Ww^Bsb\, Ww^Bsb\, Ww, Gg^Vhc, Ch, Rrc, Ww^Bsb/, Ww, Gg, Rp
Rp, Ww, Ww, Ww, Ww^Bsb/, Rrc, Ch, Rrc, Rrc, Ww, Ww^Bsb/, Ww^Bsb/, Wo, Ww, Ww, Ww, Wo^Bsb|, Ww, Ww, Ww, Wo, Wo, Ww, Ww, Rrc, Rrc, Rrc, Rrc, Ch, Ww, Ww, Gg^Vc, Rp
Gg, Gg, Gg, Ww^Bsb/, Gg, Gg, Gg, Ch, Gg, Rrc, Ch, Ww, Gg, Wo, Gg, Wo, Ww^Bsb|, Ww, Wo, Ww, Gg, Wo, Gg, Ch, Gg, Gg, Gg, Rrc, Gg, Gg, Gg, Gg, Gg
